hi - conta
hi - hallo
how are you - conta cubo
what's up - conta
what is up - conta
good day-bon dia
good morning-bon dia
good evening-bona tardi
food-cuminda
eat - come
eating - comiendo
him- e 
her- e 
mother - mama 
tonto- cunt 
bitch- puta 
water- awa 
iron - hero 
chocolate -chuculati
tea- te 
coffee - kofi 
meat - carni 
stew - stoba 
fish - pisca
hunger - hamber
we-nos
we-anos
me-ami
me too - ami tambe 
you- abo
hungry - hamber
dick - dolo 
suck my dick - chupa mi dolo
you are a dick - bo ta un dolo
your dad's dick is very big - bo tata su dolo ta hopi grandi
bitch - puta 
dumb - kens 
idiot - idiota 
stupid - lolo
moron - pendew
you are a moron - bo ta pendew 
you are dumb - bo ta kens 
you are stupid - bo ta lolo
i am hungry - ami tin hamber
you are hungry - abo tin hamber
we are hungry - nos tin hamber
we are all hungry - nos tur tin hamber
you are all hungry - boso tur tin hamber
mauricia was very hungry and thats why she ate beef stew - mauricia tabata tin hopi hamber y pasei ela come carni stoba
abandon - bandona 
abbreviate - haci mas cortico
abdicate - abdica 
ability - abilidad 
ablaze - na candela
abnormal - abnormal 
aboard - abordo 
abode - biba 
abolish - anula
abominable - abominabel
abortion - aborta 
about - tocante 
na tur banda - on all sides
i carry no money - mi no ta hiba placa cu mi 
above - ariba
above - riba
above mentioned - ariba menciona 
above all - sobretodo 
abroad - foi tera 
abscess - postema 
abscond - sconde 
absence - ausencia 
absent - ausente 
absolute - absolute 
absolution - absolucion 
absolve - absolba 
abstain - abstene 
absurd - absurdo 
abundance - abundancia 
abundant - abundante 
abuse - abusa 
to make abuse of - haci abuso di 
abusive - abusivo 
accent - acento 
accept - acepta 
acceptance - aceptaclon 
accident - desgracia 
accident -accidente 
accidental - casual
acclaim - aclama 
accompany - companja 
accomplice - complice 
accomplish - cumpli 
accomplished - complete 
perfect-perfecto
accomplishment - prestacion 
accord - acuerdo 
accordance - conformidad 
according to - segun 
according to - conforme 
account - cuenta 
accountable - responsabel 
accumulate - acumula 
accuracy - exactitud 
accurately - di acuerdo 
accuse - acusa 
accursed - maldita 
accusation - accusacion 
accused - acusado 
accuser - kehador 
accustom - acostomber 
ache - dolor 
achieve - gana 
acid - acido 
acknowledgement - reconocimiento 
inform - informa 
acquaintance - conoci 
acquaintance - conocido
liberate - libera 
acquire - adquiri 
across - na otro banda 
act - acto 
action - accion 
active - active 
actor - actor 
comedian - comico 
comical - comico 
actress - actriz 
actual - actual
sure- sigur 
adage - proverbio 
adapt - adapta 
add - conta
add- hunto 
add-agrega 
additional - adicional 
address - adres
adequate - adecuado 
adjourn - remiti 
adjust - adjusta 
adjutant - ayudante
administer - administra 
admiral - aimirante
admiral - admiral 
admire - admira 
admit - admiti 
adore - adora 
adorn - adorna 
adult - adulto 
advance - avanza 
advantage - ventaja 
advantageous - ventahoso 
adventure - aventura 
adverb - adverbio 
adversary - adversario 
adverse - contrario 
adversity - adversidad 
advertise - publica 
advertise - adverti 
advertisement - aviso 
advice - consejo 
aviso advise - conseha 
advisory - consultive 
aerial - aereo 
affair - asunto 
affect - afecta 
affected - afectado
affiliate - afiliado
affirm - afirma 
all of a sudden - diripiente
afoot - na pia 
afresh - di nobo 
after - despues 
behind -atras 
after all - enfin 
afternoon - tardi atardi 
this afternoon - awe tardi 
this afternoon - awe merdia
afterward - seguida 
afterward - despues 
again - atrobe 
against - contra 
age - edad 
aged - anciano 
old - bieu 
agency - agencia 
agent - agente 
aggravate - tenta 
agile - vivo 
ago - tempo pasa 
agony - agonia 
agree - combeni 
agreement - combenio 
ague - calor friu 
aid - juda 
aid - judanza 
aim - mik 
air - aire 
air conditioned - aire condicionado 
air conditioned - erco 
alarm - alarma
alarm clock - oloshi despertardor
alike - semejante 
peer - avocati 
all - tur 
all- henter 
all day - henter dia 
all of a sudden - di ripiente
all of the sudden - di golpi 
all the same - mes cos 
allay - alivia 
alley - hanchi 
allow - permiti 
ally - aliado 
almighty - todopoderoso 
almost - casi 
almost -hera 
alms - limosna 
aloe - aloe 
alone - solamente 
so already - caba 
also - tambe 
altar - altar 
alter - cambia 
although - aunke 
altitude - altitude 
altogether - en todo
altogether - tur hunto 
aluminum - alumino 
always - semper 
ambition - ambicion 
ambitious - ambicioso 
ambulance - ambulancia 
amend - mehora 
america - merca 
amiable - amable 
among - mei mei
among- entre
amuse - amusa
anchor - hancra
anchovy - anchovis
ancient - antique 
and - y 
and - i 
anew - di nobo 
angel - angel 
anger - rabia 
to become angry - rabia 
angry - rabia 
animate - anima 
announce - anuncia 
announcement - anuncio 
announcement - anunciamentu 
annoy - molester 
annoyance - molesto 
anniversary - aniversario
answer - responde
answer - contesta
ant - vruminga 
ant - fruminga 
anterior - anterior 
anticipate - anticipa 
antidote - antidota 
annual - anual
anvil - aanbeeld 
any - algun 
any how - di cualkier manera 
ape - macaco 
apart - aparte 
apartment - cuarto 
apathy - apatia 
apoplexy - beroert 
apostle - apostel 
apparatus - aparato 
apparel - bisti 
apparently - aparentemente 
appeal - apela 
appear - aparace
appear - parce 
appendicitis - appendicitis
apple - apel 
applicant - aspirante 
application - aplicacion 
apply - solicita 
appraise - aprecia 
apprentice - aprendiz 
approach - acerca 
appropriate - apropria 
approve - aproba 
approval - aprobacion 
approximate - aproximativo 
apron - lantera 
arch - arco 
archbishop - arzobispo 
architect - arquitecto 
arise - lanta
get up - lanta
arm - braza 
arms - arma 
arms - brasa 
armchair - poltrona 
army - ejercito 
arrange - arregla 
arrest - aresta 
book - buki 
arrival - binimento
arrival - jegamento
arrive - jega 
art - arte 
article - articulo 
artist - artista
as - asina 
as in the past - manera den pasado 
ascend -subi 
atop -subi
ascend - subi 
ash - shinishi 
ash wednesday - diarazon di shinishi 
ashame - bergonsa
ashame - cu berguenza
ashore - na tera 
aside - na banda 
ask - puntra 
aspect - aspecto 
asphalt - asfalto 
ass - sanca 
assassin - matador 
assassinate - mata 
assault - asalta 
assemble - congrega 
assert - sostene 
assign - asigna 
assignment - asignacion
assist - juda 
assist - assisti 
assistance - judanza
assistance - asistencia 
assistance- auxilio 
assistant - asistente
assurance - seguridad 
assure - asegura 
assure -sigura 
asthma - asma 
asunder - separa
as well as - tanto di como 
apart - parti 
at - na 
at least - alomenos cu
atheist - ateista 
atmosphere - atmosfera 
at night - anochi 
atom - atomo 
atop - ariba 
ontop - ariba 
attach - hunta 
attack - ataca 
attack - atake 
attack - atrae
attain - gana 
reach -alcanza 
attend - atende 
attentive - cuidadoso 
attentive- atento 
attic - atico 
attractive - atractivo
aunt - tante
aunt - tia 
aunt - tanchi
author - autor 
authority - autoridad 
autobus - autobus 
autumn - oto√±o 
avail - provecha 
avenue - avenida 
average - promedio
avoid - evita 
await - spera 
awake - spierta 
awake -lanta 
awake -desperta 
awaken - lanta 
away - foi 
awe - miedo 
axe - hacha 