bury - dera 
burial - deramentu 
burst - barst reventa 
business - negocio 
business - cuenta not your business - foi bo cuenta busy - ocupa 
but - ma 
pero 
butcher - carnicero 
butchershop. canoe butcher-shop - carniceria 
butter - manteca 
butterfly - barbuleta button - boton botona 
buy - cumpra 
by - cerca 
by day - di dia per day - pa dia by no means - di ningun manera c c 
cab - garoshi 
cabbage - colo 
cabin - kajuit 
cable - kabel 
cage - kauchi 
cake - kuki 
calculate - calcula 
call - jama 
yama calm - calmo 
calm - calma calmness - calma 
trankilidad 
calve - bise 
camera - camera aparato pa saca portret cambric - estopilla camp - campo 
can - por - can 
bleke 
canary - kanari 
cancel - cancela 
cancer - cancer 
candidate - candidate 
candle - bela 
canoe - canoa 
candy catch pandv - cos dushi 
cannon - kanon 
canvas - iona 
panja di bela cavalry - caballeria cap - pechi 
petchi capable - capabel 
capital - capital 
captain - captan 
capture - cohe presu 
car " auto card - kaarchi 
cardinal - cardinal care - 
cuida 
take care - be careful tene cuidao 
careful - cuidadoso 
cargo - carga 
carpenter - carpinte 
carpentry - carpinteria 
carpenter shop - taller di carpenteria carpenter’s tools - herment di carpinte carpet - tapijt 
carry - hiba 
carga care - cuida 
cuido 
cart - garoshi 
case - box - caha caso in case - en caso cash - cask-bari 
cash-book - buki di caha cashier - cahero 
casket - caha di morto castle - kasteel 
cat - pushi 
poeshi catch - cohe vanga 
catholic chart catholic - catholico cause - causa 
cave - cueba 
cavity - buracu 
cease - stop caba ceiling - plafond 
celebrate - celebra 
celery - selder cellar - bodega 
cement - cement portlan cemetery - santana central 
center - centre in the center - den centro mei-mei century - siglo 
ceremony - ceremonia certain - cierto sigur 
certify - certifica 
certified certificado cession - sesion reunion 
chain - cadena 
chair - stul stoel 
chairman - presidente chalice - kelki 
caliz chalk - krijt 
chamber - kamber 
cuarto 
chance - chens change - 
cambia troca 
cambio - small change placa larga chaplin - kaplan 
capelan charcoal - carbon 
charge - cobra 
charged with - encarga cu charity - caridad 
charles - carlos chart - mapa 
kaarchi  chase claim chase - corre cu 
jaag chastise - castiga 
cheap - barr^ta 
cheat 
- ganja cheese - queshi keshi chemical - kemical 
chemist - kimico 
chess - scak chew - kauw chicken - piijito 
chief - hefe 
child - jiu 
yiu mucha 
childish - muchachada chin - cachete 
chisel - belter beitei choir - coro choke - horca 
choose - escogi scoge elegi chop - kap christ - jesuchristu christian - cristian 
christmas - pascu di nace- mentu happy christmas - bon pascu feliz pascu chum - compai 
church r. c. - misa 
kerki cigar - siga 
cigarette - sigaria 
cipher - nul zero 
circular - rondo 
cistern - reenbak 
citizen - cuidano 
city - cuidad 
playa civil “ civiel 
clad - bisti 
claim - reclama 
classify collection classify - clasifica 
claw - pata 
clay - clei 
klei clean - limpi 
clear - cla 
clergy - clerico 
clerk - klerk 
empleado clever - sabi 
climate - clima 
cloak - capa 
clock - oloshi orloshi 
close - cera 
close by pega - close together cerca otro closing speech - discurso di despidida cloth - panja 
tela 
clothes - panja bisti 
cloud - nubia 
club - club 
club 
- club di cancio- neros coal - carbon 
coal-pot - confo coast - costa playa coat - bachi 
cock - gai 
coconut - coco 
cacao - cacao 
cod - bakijao 
cod liver oil - zeta di bakijao coffee - koffi coffe pot - trepochi di koffi 
canica di koffi coffin - caha di morto 
coin - placa 
cold - friu 
to catch cold bira verkoud cold chisel - corta friu 
collect - colecta 
collection - colleccion  college concerning college - colegio 
colonel - coronel color - color 
comb - penja pain-yah) combine - hunta 
come - bini 
come in - drenta come up - subi comet - cometa 
comfort - facilidad 
comfortable - comfortabel 
command - manda 
commence - cuminsa 
common - comun - common sense sinti comun commissary - comisario 
commit - comete 
committee - comite commune - ricibi 
communicate - comunica 
companion - companjero company - compania compare - compara 
compel - obliga 
compensation - compensacion compete - competi 
complain - keha complete - 
completa 
complete compensation - compensacion 
terminacion compliment - 
compli- menta comrade - compai 
amigo conceal - sconde 
concert - concerto 
concerning - tocante 
conclude consul conclude - conclui 
concrete - concreet beton 
condemn - condena 
sentencia condense - condensa 
condition - condicion 
condole - condola 
conduct - 
conduceo 
conducto 
conference - conferencia 
confess - confesa 
confession - confesion 
confide - confia 
confidence - confidencia 
confidential - confidencial 
confirm - confirma 
desorde conflict - conflicto 
conform - conforme 
confront - enfrenta confusion - bruamentu 
congratulate - felicita 
consent - 
consent! consequence - conse- cuencia 
consider - considera 
consideration - considera- cion 
consign - consigna 
consist - consist! 
constant - constante 
construct - construi 
consul - consul 
consult cost consult - consulta 
consultation - consultacion consumption - mal di pechu 
contact - contacta 
contagious - cu ta pega 
contain - contene 
content - contentu contento 
contest - 
contesta 
contesto 

concurso continue - sigi 
sigui contract - 
contracta 
contract© contractor - contratista 
contrary - contrario 
contribute - contribui 
convenience - conveniencia converse - conversa cook - 
kokki 
cook 
- (eushina 
cool - frescu 
cooper - kuiper cooperation - cooperacion 
copper - koper 
copybook - skrif cord - linja 
cork - corki 
corn - maishi 
corn meal - harinja di funchi corner - huki skina 
corporal - copra corpse - morto cadaver correct - corecto 

coregi 
correspond - correspond© 
correspondence - corres- pondencia 
corrupt - corrompi cost - costa 

prijs precio  costly cruel costly - costoso 
cotton - catuna 
cough - 
tosamentu 
tosa 
council - consejo counsel - aviso 

conseha 
count - conta 
country - tera 
patria pais cunucu couple - par 
courage - anima 
course - curso court 
- hof cousin 
- primo 
female cousin prima cover 
- tapadera 
- 
tapa cubri 
cow - baca 
crab - cangrew 
crack 
- krak crane - grua 
crazy - loco 
bela 
create - crea 
creation - creacion 
creator - creador 
creature - creatura 
^ credit - credito 
crew - tripulacion crime - crimen 
criminal - criminal 
criminal case - asunto criminal crocodile - crocodil 
crooked - corcoba 
crown - corona (koh- 

corona 
cross - 
cruz 

cruza 
cry - jora 
grita 
grito crossword puzzle - rompe- cabeza crucify - crusifica crude - crudo cruel - cruel 
;  crown deadly crown - corona 
crush 
- machica cruiser - crucero crumbs - wiri-wiri 
crush - garna 

cup - tas koppi cure - cura 
curse - zundra 
curtain - cortina 
cushion - cusinchi 
custom - costumber 
cut - corta 
d d 
dad - papa 
daddy - papasito 
daily - diaria 
dam - dempel 
damage 
- dan jo 
dame - dama 
senora 
dance - balia 
danza dancer - baliador 
dancer 
- bailarina 
danger - peligro 
dangerous - peligroso dare - risca 
darling - dushi 
amor dark - scur 
darkness - obscuridad scuridad date - fecha 
date 
dadel 
daub - smeer 
daughter-in-law - nuera 
dawn - 
manise^ at dawn today - awe su manise marduga 
dawn - marduga 

amanece day - dia 
daybook - diario day-time - di dia dead - morto 
deadly - mortal 
deaf deaf - surdo 
deal 
- negocia negocio 
dealer - negociante dear - estimado 
death - morto 
debate - debeta 


debate 
debit - debe 
debt - debe 
decay - putri 
decease - muri 


difunto 
deceive - ganja 
deceit - ganjamentu 
december - december 
decency - fatsoen 
decent - decente 
decide - dicidi 
resolbe 
decision - decision 
decicion defense deck - dek declare 
- declara ; decline - bahamentu ■ 
; bai atras ^ decorate - dorna 
decora 
i dedicate - dedica 
| deduct - kita afo « 
deed - acto 
m deep - hundu 
profundo 
deer - bina 
a deface - disfigura a 
danja a defeat - derota 
bati 
()v) rendicion fl defective - defecto fl 
kibra i 
fl defend - defende 
defense - defensa 
defer desire defer - dilata 
define - describi 
definition - definicion deform - deforma 
defy ' provoca 
degenerates- dege¬ nera 
degrade - ba.ba demota delay - dilata 
tene atra.s tarda delicate - fini 
delicado 
deliver - entrega 
libera 
deluge - diluvio 
deny - ninga 
nenga denial - nengamentu 
denote - bedei indica dental - dental 
dentist - dentista 
depart - parti 
sali 
departure - despedida 
depend - depende 
dependent - dependente 
deplore - duel 
sinti deposit - 
deposito 
deprive - horta 
kita depth - hundu 
deputy - deputado 
derive - deriva 
conclui 
desert - bandona 
deserve - merece 
design - pinta designa dibuhante desire - tin gana 
desea  desk directed desk - lesna 
despair - desperacion 
desespera 
despatch - despatcha despise - desprecia 
destiny - destine 
destroy - destrui 
destruction - destruc- cion decline - tene di 
nenga detective - detetivo 
develop - develop desaroyo devil - diablo 
- diabel devour - guli 
dew - dauw 
diamond - diamante 
dice - dao 
dictate - dicta dictacion dictee dictionary - diccinario die - muri 
diet - dieet dieta 
differ - diferencia 
difference - diferencia difficult - dificil tra- bahoso 
difficulty - dificultad dig - coba 
digest - digiri 
dim - scur 
dine - come 
dining-room - comedor 
dinner - cuminda 
diptheria - difteria diploma - diploma 
direct - directo 
direction - direccion directory - directoria 
directed - dirigi 
dirt disease dirt - shushi 
^ disable - manca 
disagreeable - desa- gradabel 
disagreement - pleitu 
disappear disparce somenta disapprove - condena desaproba haja main disaster - calamidad desastre disband - disolve separa 
disburse - paga 
discard - tira afo 
discern - distingi 
discharge - despacha 
disclose - revela (
maniferte 
discolor - bira bleek perde color troca color discomfort - molester 
descom- fortabilidad disconnect - los discontent - mal con- tentu 
discontinue - stop discontenua 
discourage - disanima kita animo discourse - combersacion predicashi 
discover - descubri 
discreet - discrete 
discriminate - descri- mina 
discrimination - descri- minacion discuss - discuti 
discussion - discurso 
disease - malesa enfermedad si disembark disembark - desembarca disengage - los emancipa 
libera disfavor - disgracia 
disgrace - berguenza 
disguise - disfrasa 
disg-ust - disgusta 
dish - hasechi 
dish-cloth - serbete di cushina dishonest - inhusto 
falsu 
to play dishonest - hunga wega di ladron dishonor - dishonera 
sin respeto disinfect - disinfecta 
disjoin - parti 
separa 
distance disk - skijf 
| disco 
| dislike - avercion | 
dis-  gusto i dismiss 
-  dispacha i disobey - no tende na i disobedece  disorder - disorde i disparity - disparidad i 
:i dispatch - despacha  dispel - corre cu  saca  dispense - distrui 
■ displace - hala mov ■ fo un luga na otro ■ displease - disgusta m 
m dispute - pleitu m 
m disrobe - kita panja s dissolve - disolve w 
fl distance - distancia  
distinct dress distinct - cla 
district - districto district representative - representando di dis¬ tricto distinguish - distingui distract - distrae distress - nood nece- sidad distrust - disconfia 
dive - sambuja 
diver - sambujador divine - divino 
division - division 
divide - divida 
parti divorce - divorce 
do - haci dock - dok doctor - dokter doctrine - doctrina 
dog - cacho 
doll - popchi pauchi dollar - fuerte dollar dome - capula 
domicile - domicillo 
i dominoes - domino dose - dosis double - dobbel doubt - duda - without doubt - sin duda dough - mansa 
dove - palomba 
down - abao {abow)bao i draughts - dam 
draw - pinta 
dibuja 
drawer - lachi 
dread - miedo dream - sonjo 
sonja 
dregs - cocolo 
drench - papa muha 
dress - 
bisti panja 
dress - 
bisti 
edition drill - boor 
drop 
- gota 

laga cai tira abao t drug - droga 
druggist ' boticaria drugstore - botica drum ' tamboer ^ drummer - tocado di tamboer drunk - burachi 
dry - secu 
(adjlverb - seca duck - patu 
dull - stompi 
dumb - mudo 
during - durante- duration duramentu dusk - scuridad 
dust ' stof   duty - deber 
dwarf - enano dwell - habita 
biba 
dwelling - cas dye - tinzji . dysentry - 
e 

e 
he she the it 
each - cada 
ear - orea 
early - tempran 
earnest - serio 
earn - gana 
earnings - gano ^ noh) ganamentu 
earring - renchi di orea (ren-chee dee 
earth - tera 
easily - facilmente sst - oost 
pa riba easter - pascu di resu- reccion easy - facil 
^lihe 
eat - come 
eaten comi 
edition - edicion  empty edge edge - kantu 
banda 
educate - educa 
education - educacion 
effect - 
resulto 
efficient - adecuado 
effort - esfuerzo egg - webu 
eight - ocho 
eighteen - diez-ocho eighty - ochenta 
^ he she it - el e elastic - lastik 
elastick elbow - cocoti 
eldest - e di mas bieu elder - mas bieu 
election - eleccion elect - elegi 
electric light - luz electrica electricity - electrici- cidad 
electrician - electri- cista 
elephant - olifante elementary - elementario eleven - diez-un elope ' hui 
else - otro 
embark - barca embarass - haci timido 
embezzle - horta 
emblem - emblema 
embrace - braza 
emigrate - emigra 
eminent - eminente emperor - emperador employ ' emplea 
employer - empleador 
employment - empleo 
empress - emperatriz empty - bashi 
enamel examine enamel - verf encouragement - anima- cion enclosed - encerra end - fin 
cabamentu 
endorse - firma 
enemy - enemigu 
energy - energia 
engineer - ingenero 
engine - mashin 
motor 
enjoy - gosa goza 
engrave - graba 
engraver - grabado enjoyment - gosamentu enlarge - haci mas grande agrandisa 
enough - basta 
ensure - segura 
enter - drenta 
enterprise - empresa 
entire - henter 
entirely - hentere- mente envelope - envelop epiphany - tres rey equal - igual 
pareu equally - igualmente 
looks like parce 
equipment - equipo 
err - hera falta errand - responde 
error - error falta escape - scapa establish - establece 
event - evento every - tur 
every-one tur hende everything tur cos every other day - cada pasa un dia every day - cada dia exact - exacto 
examine - samina 
examination factory examination - examen example - ejemplo ehemplo 
excellent - excelente famoso except - excepto saca 
exception - excepcion 
excess - di mas 
exclaim - sclama 
excursion - excurcion 
excuse - excusa 
pardona executive - ehecutivo exhibition - exhibicion exist - existi 
expand - expande blra mas grandi expect - spera 
expel - saca 
expensive - car a 
experience - experiencia explain - splika 
export - exporta 
extend - extendi 
express - expresa 
extend - extende 
extreme - extreme 
extreme unction - santoli eye - wowo 
eyeball - popchi di wowo eyebrow - cabei di wowo eye specialist - oculista 
dokter pa wowo f f 
fable - historia 
cuenta fabric - stof fabricate - fabrica 
face - car a 
facilitate - facilita facility - facilidad 
factory - fabrica 
fade feel fade - verlep troca color fail - facasa 
falta to fail an exam zak fair - honestu 
bunita 
faith - fe 
faithful - fiel 
fall - cai 
false - falsu 
fame - fama 
familiar - familiar 
family - famia 
familia fan - waaier 
far - leu fare - comida 
pasashi farewell - adios ajo farmer - cunucero 
farther - mas leu farthest - e di mas leu fast - lihe duro - he runs fact - e ta corre duro fasting - ajuna ayuno fat - gordo 
fate - destine 
fucu 
father - tata 
father-in-law - suegro 
fatherland - patria 
fatigue - fatiga 
cansa fatten - gorda fault - culpa 
falta causa favor - fabor 
favorite - favorite fear - miedo sustu 

spanta feast - fiesta 
feather - pluma 
february - februari feed - duna cuminda feel - sinti 
fula 
to feel with the hands  feet fold feet - pia 
felt - fieltro 
female - muhe 
fencing - wega di floret fetch - hala trece few - poco 
fever - keintura 
fiddle - viool 
field - campo 
fifteen - diez-cinco fifth - e di cinco fifty - cincuenta 
fight 
- bringa file 
- lista 
file 
- vijlu 
vijlo fill - jena 
yena filthy - sushi 
find - haja 
haya hanja fine 
fini finger - dede 
finger nail - hunja una finish - caba 
fire - candela 
first - prome 
promer first floor - prome piso fish - pisca 
fisher - piscador fist - moketa 
conopi fit 
- pas five - cinco ) 
five o’clock cinc’or fix - drecha 
fix up matters drecha cuenta flag - bandera flame - vlam flea - pruga flee - hui fleet - escuadra flesh - cami floor - vloer §uela flour - harinja di pan bloem flower - flor 
flowerpot - florero fly - 
moskita muskita 
fly . 
bula 
fold ' dobla 
fool fool - loco 
football - futbal for - pa 
forbid - prohibi 
force - forza 
foreign - stranjero 
forest - bos mundi forfeit " caduca forget - lubida 
forgive - pardona 
fork - vorki forki form - formaleta 
formal - formal formerly - antes prome aja fort - forti 
fortune - fortuim 
fortunate - fortunado 
fortunately - afortuna- mente forty - cuarenta 
foto - portret four - cuater 
four o'clock cuat'or fourth - e di cuater fowl - galinja 
fox - vos fraction - fraccion fracture - fractura 
fragile - bros frame - leishi free - liber 
freedom - liberdad 
freeze - vries frequent - frecuente frequency - frecuencia hopi bez hopi biaha fresh - frescu 
friday - diabernes friend - amigu 
amigo friendship - amistad 
fright - spantamentu miedo sustu frigid - friu frlo  frock gasp frock - bisti saya japon frog " dori 
sapo 
fruit - fruta 
fry 
hasa 
frying-pan - panchi fuel oil - azeta di kima full ' jen yen full moon luna jen fun - chansa 
funny - stranjo funeral -■ deramentu 
furnace - fornu 
forno furniture - mueble further - mas leu furthest - e di mas leu g g 
gable - frente front gain 
- gana 

- gano ganamentu gainful - probecho 
gait - camnamentu 
gale ' tempestad stormo gall - gal 
gallant - galante 
gallery - adrei hadrei gallon - galon 
gallop - corre-duro gallows - horca 
gamble - hunga dao 
gambler - hungador di dao game - wega 
gang of workmen - cuadrija 
gangrene - gangrena gaol 
- prison calabus 
garb ' bata 
garden - jardin gardener - jardinero gas - gas gaslight - luz di gas gasoline - gasolin 
gasp - anehla 
gate give gate - porta 
gather - colecta 
gay “ alegre 
gaze - keda mira 
waak gear - rueda 
gender - sexo general - general universal en general general - general 
generally - generalmente 
generate - produci 
generation - generacion generosity - generosidad generous - generoso 
gent - shon meneer senor gently - ketu 
poco-poco genuine - franco sincero lehitimo 
germ - microbio 
german - aleman get - haja 
hanja - get down baha get going - cuminza - get out - sali afor get in - drenta - get a fall - cai - get a cold - bira verkoud - get wise - bira sabi - get married - casa get sick - bira malu - get well - bira bon mehora get up - subi lamta get rich - bira ricu ghost - spiritu - holy ghost spiritu santo ghost - zumbi giant - gigante giddy - maria biramentu di cabez gift - regalo 
gigantic - gigantesco gild 
dora 
gill - cai-cai gimlet - boor gin - jenever bols ginger - gember girl - mucha-muher 
give - duna 
i glad governor glad - contento ^ 
alegre 
gladness - joy - alegria 
glance - mirada 
gland - klier 
glare - lombra 
glass - glas glassware - cos di glas glide - slip 
glimmer - brilla brija 
globe - globo 
gloom - scuridad 
glorious - glorioso 
glory - gloria 
glove - hanskun 
glue - lijm go - bai - go out sail - go in drenta - go ahead - sigi 
goat - cabritu 
god - dios god willing dios kier 
godfather - padrina godmother - madrina pepe god-son - iho gold- -oro gold watch - orloshi di oro goldsmith - plate 
gulf - ola 
gulf - 
lago good - bon 
good-bye - adios a jo 
good friday - diabernes santo biernes santo goodness - bondad 
goods - mercancia 
good-will - bon-volontad 
goose - ganza 
gossip - papia ariba cuenta di otro hende govern - gobema 
government - gobierno governor - gobernador  gown group gown - chimis 
grammar - gramatica 
grenade - granata 
grace - gracia 
graduate - gradua 
grain - grano 
grand - gran 
grade - klas grado grandson - nieto 
grand-daughter - nieta 
grape - druif grandfather - tawela 
grandmother - wela 
grass - jerba 
grasshopper - tiracochi gray - color di shinishi 
great-granddaughter - bisanieta great-grandfather - bisawelo great-grandmother - bisawela great-grandson - bisanieto greater part - majoria parti greedy - pichiri (pee-chee- 
green - berde 
greens - berdura grey hair - cabei bianco grievance - keho 
grind - mula 
grindstone - piedra di mula groan - keha groove - groef gruf 
gross - 
gros 
ground - tera tereno 
groundfloor - promer piso 
group - grnpo 
grow grow - crece 
grudge - rancor grumble - grunja guard - 
warda 
waak wardar- door guardian - voogd guess - raai 
guest - bishita 
guide - gija 
guia guilt - culpa falta guitar - gitar 
guitarra gum - gom gumb 
- encia 
gun - scopet gunner - canonero gut - tripa 
shiri-shiri 
gypsum - yeso h h 
habit - custumber 
hand had - tabatin 
tawatin 
hail - hagel 
hair - cabei hair-brush - skuier di cabei 
hair-comb - penja 
hairpin - gancho 
feneta di cabei 
hale - salu 
half - mei mitar 
half breed - hawashi 
half dead - casi morto mitar morto half-past one - 
mitar di diez-doz - un or y mei hall - sala 
ham - ham hammer - martin martiu 
hammer-handle - man di martiu hand - man 
handbag head-breaking handbag - tas cartera 
handfull - man jen 
handicap - obstruccion handkerchief - lensu lenso 
handle - man 
handrail - man di trapi handsaw - zaag handsome - bunita bonita hand-work - trabao di man hang - colga 
cologa hang-man - borduga 
happen - socede 
harbor - haf harbormaster - hafmees- ter hard - duro dificil 
hardly - apenas 
hare - haas harp - arpa 
harpoon - arpun 
has -tin harvest - cosechi 
haste - pura 
hasten - pura 
haci lihe hat - sombre - straw hat sombre di cabana - felt hat - sombre di lana hatch - broei 
hatchet - hacha 
hate - 
odio - 
odia hatred - enemistad odio haul - hala 
ranca 
saca 
have - tin 
hay - hooi 
hazard - peligro 
haze - nubia 
he she it - e 
el head - cabes cabez 
head-ache - dolor di cabes 
head-breaking - rompe- cabeza  heal hinder heal - cur a 
health - salud 
healthy - salu 
heap - monton 
hear - tende 
heart - curazon 
heart-burn - acido den stoma heartily - carinjoso 
heat - calor 
heaven - cielo heavy - pisa 
heed 
-tende heel - hielchi (heel- chee he goat - chubatu 
height - haltura 
heir - heredero 
hell - fierno 
helm - man di timon 
help 
- juda yuda 
- 
judanza helper - ajudante 
hem - zoon zom hen - galinja (gah-leen- 
here - aki aqui - here in aki den - here on aki riba here it is - ata heretic - hereje hero - held herring - pekele 
her - su her-self su mes hesitate - duda 
hew - kap corta 
hide - sconde 
high - haltu 
high mass - misa mayor highway man - saltadeo higher - mas haltu highest e di mas haltu hill - ceru cero 
him - e 
hinder - stroba 
how hinge - skarnier 
seamier hint - senja 
hip - heup custia costia hire - huur hier his ' su 
hoarse - heers hoe - chapi 
hog - porco 
hoist - hiza hisa 
hold - tene - hold of a ship bodega hold up wanta hole - buracu 
hoi holiday - dia di fiesta dia liber holy week - semana santo holy thursday - huebes santo holy sea - santa seda holy - santo holywater - awa bendita home - cas 
at home na cas honest - justo honestu honrado honesty - honradez fran- kesa 
honey - miel honing honey-moon - luna di miel honor - honor 
hood - tapa kap calashi 
hoof - pata 
hook 
- anzue haak hope - spera 

speranza 
hopeless - sin speranza 
horizon - horizonte horn -• cachu 
horrible - horibel 
horse - cabay hose - mea 
hospital - hospital hospitality - hospitali- dad host - donjo di cas hot - cajente 
hour - ora house ' cas how - com  however iguana however - sin embargo toch hue - color hug 
- braza huge - grand! hull ' curpa romp! 
humane - humano humble - humilde 
humming-bird - blench! humor - humor hundred - cien hundredth - e di chien hunger - hamber hungry - tin hamber 
hunt - jaag hunting - jaagmento hurry - pura haci lihe hurt ' herida machica danja husband - casa esposo hush - keda ketu hut - camaroti 
hymn - cantica cancion i i 
i - mi 
ami 
ice - ijs 
iceberg - ceru di ijs ice cream - ijscrem idea - idea 
ideal - ideal 
identical - mes cos 
identical 
identify - indentifica 
idiot - idioot idiom - idioma idle - bashi 
floho 
if - si 
ignorance - ignorancia 
ignorant - ignorante 
bobo 
iguana - juiana 
ill imprison ill - malu 
ill-bred - mal cria 
illegitimate - ilehitimo illicit - ilegal 
cu no ta legal ilehitimo illness - malu 
malesa 
enfermedad ill-treat - trata malu 
- maltrata 
illuminate - lusa 
ilumina 
illustrate - ilustra 
illustration - illustra- cion ill will - rabia 
image - imagen imagine - imagina 
imitate - imita 
immigrant - imigrante immigrate - imigra 
immediate - un bez immigration - imigracion immoral - inmoral 
impertinent - tribi 
soberbe 
impetus - stimulo implore - pidi 
import - importacion impolite - descortes import - 
importa 
importance - importan- cia important - importante 
impotence - impotencia imposter - ganjado impress - impresa 
impression - impresion imprecion imprison - cohe presu 
imprisonment industry imprisonment - prison piscalat calabus wangalan improve - mehora 
impulse - impulse in 
den - pa den dentro - in front of dilanti inn-keeper - posadero in advance 
- antenano - in case of en caso inactive - floho poco- poco inactive in as much - pasobra 
in case - si acaso - in default of - pa falta di - in behalf of - na provecho di incense - censia inch - duim pulgada 
in charge of - encarga cu incidental - casualmente inclined - dispuesto casualidad inadvance - antenano in nacion incendiary - quimado kimado incident - incidente inclose - aden 
aki den 
include - inclui - inclu- sivo-cu conta den - cu acerga incompetent - incompo- tente incomplete - incomplete incorrect - inexacto income - ganamentu increase - aumenta incurable - incurabel indeed - en berdad indian - indian indicate - indica 
indigestion - indigestion indirect - indirecto 
indiscreet - indiscreto individual - individuo individual indolent - tragico 
industry - industria  industrial relations insurance industrial relations dept. - departamento di relaciones industrial infant - jui di lechi infantry - infanteria infect - infecta inferior - inferior inflamation - inflamacion influence - influencia influenza - griep verkoud information - informacion inform - informa avisa inhale - inhala 
inhabit - inhabita inherit - hereda 
initial - firmo 
firma 
initiate - inicia injection - injecion injure - perhudico haci danjo injustice - inhusticia ink - ink tinta innocence - inocencia innocent - inocente in order to - a fin di inquire - puntra 
averigua insane - loco insect - insecto insert - inserta hinca inside - pa-den insincere - insincere inspect - inspecta inspection - inspecion inspector - inspector inspire - inspira inspiration - inspiracion insist - insisti install - instala instant - instante instantly - djis 
un bez umbe 
instead - lugar di instinct - instinto institute - 
funda establece 
institute instruct - sinja instrui instructor - instructor^ instruction - instruccion instructive - instructive instrument - instrument© insult - zundra insure - sigura garan- tisa insurance - siguridad seguro aseguro  in such a way irrigate in such a way - tal manera intact - henter intacto intellect - tino sinti intellectual - intelectual intelligence - inteligencia intelligent inteligente intend - intencion tin intencion di intent - intento interesting - interesa intercede - pidi pa intercept - intercepta interchange - cambia interest - interes interested - interesa - interesting intere- sante interior - interior intermediate - intervene intervencion 
interment - entierro international - interna- cional intern - interno internal - interno pa den in the afternoon - tramerdia atardi in the air - den aire intimate - intimo intermission - diberta- cion interpret - traduci 
interrupt - interumpi corta palabra interview - 
pidi un conbersacion cu 
entrevista intimate - intimo 
into - den pa den intoxicated - burachi introduce - introduci introduction - intro- duccion innundation - inundacion invent - inventa inventory - inventario haci inventario invisible - invisibel invitation - invitacion invite - combida invita involve - lora hinca 
inward - pa den irregular - iregular irrigate - muha moha  irritate judged irritate - irita irritation - iritacion is - ta 
island - isla 
isolate - isola 
issue - edicion it - e 
itch - sama grava- mentu grawtashi item - pieza its - su di je itself - su mes 
ivory - ivoor 
j j 
jacket - bachi 
jail - prison 
picala 
calabus 
jalousie louver - shalusi 
jam - jam 
jamb - primi 
january - januari jar - canika 
jaw ' kakenbein 
jealous - jaloes 
jeer - bofona 
haci mofa 
jerk - ranca 
jessamine - jazmin jew - judio hudiu 
jewel - prenda 
job - trabao 
join - hunta 
junta joined - 
hunta 
joist - balki 
joke - chansa 
viaha joy - alegria 
judaism - judaismo judge 
- huez 
judge 
- huzga 
juzga judged - huzga 
jug knowledge jug - butishi 
water jug poron 
jump - bula 
salta jumped - bula 
junk - djonki 
pida 
just ' asina 
eso es justify ' justifica hus- tifica k k 
keel - kiel 
keep - tene 
kerchief - lensu 
kerosene - kerosin 
key - jabi 
yabi kick - skop kid - jiu yiu ju 
kidney - nier 
kill - mata 
killed - mata 
kind - bon carinjoso 
kind - sorto 
king - rei 
kingdom - reino 
kink - conopi 
kiss - sunchi 
zunchi knee - rudija 
rodia kneel - 
hinca rudija 
knife - cuchu 
knight - cabellero knock - bati knocknee - pia krepts pia chuchara knob - conopi 
know - 
sabi sa 
conoce 
know - 
conoci 
knowledge - ciencia conocementu   lead l l 
label - etiket 
labor - trabao 
laborer - peon 
lace 
- veter 
kanchi 
lack - fait a 
lad - mucha 
ladder - trap! 
lade 
- carga 
lady - sehorita senjo- rita sefiora senjora lake - lago lamb - lamchi 
lame - lam 
lamp - lamp! 
land - ter a 
tereno 
land 
- bai tera landscape - bista bee-stah) language - idioma 
lenga lantern - lanterno lap - scochi 
larceny - hortamentu lad- ronisia lard - rees 
large - grand! 
last - ultimo 
- last week siman pasa last 
- dura 
late - laat tardi later on - aworo latter - e ultimo menciona laugh - hari 
laundry - labanderia 
laundress - labadera 
law - ley lawsuit - proceso lawful - legal lehitimo. lawyer - abogado 
lay down - drum! abao lay eggs - pone webu 
lazy - floho lead
- chumbo 
lead 
- lei companja 
leaf lice leaf - blachi 
leak - lek 
leap ' bula 
leap-year - anja bisexto learn - sinja 
learning - ensayanza 
least - di mas menos - at least alomenos leather - cuero 
leave - sali 
laga 
lecture - lectura 
left 
- robes 
left over - sobra 
leg ' pia 
wesu di pia palu di pia pata 
legal - legal 
legible - leibel 
lemon - lamunchi 
lemonade - limonada 
lend - fia 
length - largura 
lent - cuaresma leper - leproos 
leprosy - lepra 
less - menos 
lesson ' les 
let - larga laga - let’s go. bam letter - carta 
letter letterbook - copiador lettuce - lechuga 
level 
- waterpas - 
plat levy - 
hisa 
liar - ganjado 
liberate - libera 
liberty - libertad 
library - biblioteca 
lice - pieuw 
license lose license - permiso 
lick - lembe 
lid - tapadera 
miembro lie 
- drumi 
lie 
- ganja lie
- ganjamentu left - hiza hisa 
light 
- lus luz - 
lihe 
light 
- cende pega lighter 
- launcha lightning - weerlicht lamper rayo like 
- gusta 
limb 
- taki 
- of the body - miembro lime - kalki 

lemunchi limit - limete 

limita line - regia 
linja cabuja fini linger - keda 
keda atras lion - lion 
lip - lip 
liquid - likido liquido listen - scucha 
little - chikitu poco lizzard - ragadishi lagadishi live
- biba 
lively - bibo 
load - carga 
loaf - pan 
lobster - kreeft local - local lock - slot lonely - solitario long - largo 
look - mira 
weita weta 
look for - busca 
loose - los lord - senor senjor lose - perde 
loss manager loss - perdida perde- mentu lot - fucu 
lotion - locion louse - pieu 
love 
- amor stimam.entu love 
- stima 
loved - stima 
lover - stimado 
amante low - abao 
luck - suerte to be lucky tin suerte lumber - palu 
madera liimp - klompi pida 
lunch - lunch almuerzo lung - pulmon luxury - luho luxurious - luhoso lysol ' lisol m m 
ma - mama 
machine - mashin 
maquina mackerel - makre 
mad - loco 
made - a traha magic - bertu magnificant - magnifico mahogany - caoba 
maid - mosa house maid cria 
mail - post main - principal 
maintain - mantene sos- tene 
maize - maisji 
major - mayor make - traha making - trahando haci malaria - malaria 
mallet - martin di palu man - homber man-of-war - bapor di gera 
manage - maneha 
manager - administrador hefe  mane mane - clina mango - mango mangrove - mangel manhood - hombresa 
mania - mania 
manner - manera moda estilo many - hopi mucho masha map - mapa 
marble - alabaster 
malbu kniki march - maart march - 
marcha mare - jewa margin - kantu 
marine - marinero 
mark 
- marca raspa market - mercado marshe 
marmot rochi marriage - casamentu matrimonio married - casa 
marrow - manteca di wesu merg marry - casa 
marshal - mariscal martyr - martir marvel - milager milagro mask - masker mason - mesla free mason mason massage - hala 
mat - mat match - lusafer 
lucifer swaaf material - material 
matrimony - matrimonio matter - cuenta 
what’s the matter? ki falta? may - por may be podice may - 
mei me - mi 
meal - cuminda 
mean - 
meen 
nifica mean - nificacion  means military means - medio 
m^easles - serampi 
measure - midi 
meat - carni 
mechanic - mecanico 
meddle - entremete mors mishi meddle with - mishi cii 
medical - medical medico medical advise aviso medico medicine - remedi medi- cina mediocre - regular pasa- bel medlar - mispu meet - contra cu topa cu encontre cu meeting - reunion melody - melodia melon - milon melt - dirti member - miembro memory - memoria mend - drecha 
mended - drecha 
mental - mental merchant - comerciante mercy - misericordia merit - merita 
merry - alegre 
contentu message - respondi 
men- saje metal - metal 
meter - meter 
method - metodo 
middle - centro mei- mei midnight - mei anochi media nochi midwife - vrumon partera might - 
por 
mighty - poderoso fuerte migrate - imigra troca cas potente mild - suave 
mile - mija 
military - militair  milk modern milk - lechi 
mill - mulina 
mimic - imita 
mind - 
tino 
sinti to have a mind tin gana mine - di mi 
mine 
- mina 
minister - dommi 
minister - ministro 
minus - min kita 
minute - minuut minuto minute hand - minuut wij- zer miracle - miraclo miraculous - miraculoso mirror - spiel 
miscarriage - aborto 
miscellaneous - difi- rente mischief - maldito 
miser - hende pichiri mischievous - malucu 

miserable - miserabel misery - miseria 
mishap - disgracia mishandle - maltrata 
miss 
- falta hera - sinti falta di miss - senorita missionary - misionarie mist - nubia neblina mistake - falta fout mistaken - ekiboca mister - shon seiior meneer mistress - senora shon mevrouw mistrust 
- desconfia 
desconfianza mix - mezcla brua 
mock - bonfona haci mofa mockery - bofon mofa model - model 
tipo moda 
moderate - modera 
modern - moderno 
modest move modest ^ modesto 
modesty - modestia 
modify - modera 
moist - muha moha 
molasses - stropi 
molest - molester 
moment - momento 
monarch - monarkia monarco monday - dialuna 
money - placa cen 
monitor - monitor monkey - macacu 
monster - monstruo 
monsterous - monstruoso month - luna 
moon - luna 
monthly - mensual tur luna cada luna monument - monumento mop - feila 
more - mas 
morning - mainta 
mortal - mortal 
mortar - material 
mortgage - hipoteek mortise - buracu di pen 
most - e di mas mosquito - sangura 
mother - mama mother-in-law' - suegra 
motion - mocion motive - motibo 
motor - motor 
mountain - ceru 
mourning - den rouw mouse - raton 
moustache - pigoti 
mouth - boca 
move - moov muf  movement natural movement - movemento much - hopi cantidad mucho mud - lodo 
mule - mula 
mullet - mula multiply - multiplica multitude - multitude raultitud mumps - cachete 
murder - matamentu asesi- nato murderer - matador asesino murder 
- mata dal mata asesina 
mushroom - djipopo para¬ sol di zumbi muscle - musculo museum - museo must - meste mester mute - mudo 
mutton - carni di came muzzle - boca 
my - mi 
myself - mi mes 
mysterious - misterioso 
mystery - misterio 
n n 
nail - hunja 
- clabu 
material nail 
- bati clabu dal clabu claba nailed 
- claba 
naked - sunu 
nudo 
name - nomber. what’s your name? ki bo nom¬ ber ta? com jama bo? nape - nek napkin - serbetter di boca narrow - smal nasty - shushi 
fies 
nation - nacion national - nacional 
native - jiu di tera 
nature - naturalezga natura 
natural - natural 
naughty news naughty - malucu 
nausea - biramentu di stoma maria 
naval - marina navel - lombrishi 
navigate - nabega 
near future ^ future cer- cano navy-blue - blauw-scur near - cerca 
nearly - casi (kah-see neat - nechi 
necessary - necesario 
necessity - necesidad nay-say-see-d at) neck - nek neck-tie  dashi 
necklace - cojar 
need - mester noodi tin mester needle - angua 
needy - pober 
negative - negative 
neglect - 
negliga 

negligencia descuido descuida 
negotiate - negocia 
neigh - grita 
neighbor - bisinja 
neighborhood - bicinidad loga cerca neither - ni 
nerve - nervio 
nervous - nervioso 
nest - neishi 
neutral - neutral never - nunca 
never the less - no obstante new year’s eve - bispo di anja nobo new year - anja nobo news - nobo noticia 
newspaper nude newspaper - corant nice - dushi 
night - nochi (noh- chee - at night anochi night shift - warda di anochi nightly ' nocturno nine - nuebe 
ninth - e di nuebe ninety - nobenta ninetieth - di nobenta no - no noble - nobel 
nod 
- cabisha 
no how ' ningun manera noise - boroto borchincha nominated - nombra none - ningun 
nonsense - coi loco noon - merdia atardi at noon atardi - good afternoon - bon tardi nor - ni normal - normal 
north - nort noord nose - nanishi 
' nose holes buracu di nanishi not - no notary - notario note - nota carta 

nothing - nada 
notice 
- anuncio 
notice - 
anun- cia 
notify - 
- publica proclama notification - proclamacion notificacion not with standing - sinembargo 
now - awor now-a-days presently - _ awendia 
nowhere - ningun parti ningun caminda nozzle - tip nude - sunu nudo 
nuisance of nuisance - praga 
numb - sin gevoel doof number - numero numerous - numeroso nun - soeur 
nurse - zuster nurse menchi nut - nechi 
nut-nig “ notcn muskaat netomuscat o o 
oar - rema 
oath - blafemia maldicion 
huramentu 
oath 
- hura 
obedience - obedecida 
obedient - obedecido 
obey - obedece 
object - obheto 
objection - objeccion obligation - obligacion oblige - obliga 
observation - observacion observe - observa weita mira obsolete - bira blew 
obstinate - persistente obstina obtain - haja obtene occasion - ocasion occupy - ocupa 
occur - socede pasa ocuri ocean - oceano o'clock - or - four o’clock cuat’or odd - noms - twenty odd binti y pico odor - olo holo 
of - di 
order offend - 
ofende 
offense - ofensa 
offer - 
ofrece 
presenta office - oficina 
officer - officier ofi- cial official - ambtenaar oil - azeta zeta 
oil can - canika di zeta ointment - inguente old - bieu 
old age - ireges biches old year’s eve - bispu di anja nobo old times - antigua olive oil - azeta dushi olive - olijfi 
omission - descuido 
omit - salta pasa omelet - rurom fertada omnipotent - todo pode- roso omnipotente on - ariba riba  on account of - pa causa di once - un bez un be 
at once di ripiente un vez onion - sibojo 
only - so solamente open 
- habri 
open - habri 
operate - opera 
operation - operacion opinion - opinion opportunity - oportumdad ocasion - to take the opportunity probecha di oportunidad oppose -- resista opone opposite - contrario 
oppress ' oprimi orange - apelsina order 
- sorto areglo combenio entrego order 
- entrega pidi manda busca  pansy organ - orgel organist - organista orphan - huerfano ostrich - avestruz other ' otro otherwise - otro manera 
our - nos ours - di out - afo afor afoi outside - pa for outstanding - sobre- saliente oven - fornu over - ariba overcoat - sobretodo overlap - cubri tapa owe - debe 
owl - palabrua shoko own - my own - di mi mes - his own di su mes owner - donjo ox - buei p p 
pa - pai papa pace - camnamentu 
pack - paki 

pak pacify - pacifica pad 
- blokki di papel paddle - pagai 
pad-lock - candal pagan - pagano 
page - pagina 
pain - dolor to have pain - tin dolor - to give pain - haci dolor paint - verf pintura 
pinta pair - par 
pal - amigu 
compai 
pale - bleek 
palm - palma - 
planta di man palm sunday - diadomingo di rama pan - weja 
pane - raampi di glas pansy - pensamento  pantry penal servitudel pantry - provishi pants - carzon 
pap - papa papaw ' papaya paper - papel 
parade - parada paradise - paraiso parcel - paketa 
parch - rooste rooster pardon - 
pardon pardon - 
pardona 
parent - pariente mayor park 
- alemada 
parki park 
- parkeer 
parrot - lora prikichi 
parson - dommi part - parti 
partake - tuma parti party - fiesta balia party - partida 
pass - pasa 
pass - 
pas passage - pasashi 
passenger - pasahero past - pasa 
paste - pasta 
pasteboard - carton pastor - pastor patch - lapi 
patience - pasenshi 
patient - cu pasenshi patridge - patrishi pattern - model pause - pausa paving stone - plavei pay - paga 
pago 
- payroll - tarifa di pago payment - pagamentu pea - boonchi ert peace - paz peacock - pavis pear - pera 
pearl - perla peep ' loer pen - pen - penholder - koker penalize - castiga 
penal servitude - castigu di morto  penalty pile penalty - castigu 
pencil - potlood pending - pendiente penetrate - penetra pennant - wimpel pep 'tut pepper - promente 
permit 
- permiso perfume - perfuma 
awa di olo 
perjurer - jurado false hurado falsu period - periodo permit 
- permiti (per- mee-tee perish - perece perpetual - perpetual persecute - persegui persist - persisti person - persona hende 
personal - personal perspire - soda 
perspiration - sodo 
persuade - persuadi persuasion - persuasion peruse - lesa door pest - praga petal - blachi di flor petition - peticion petrol ' petrol pharmacy - botica pharmacist - boticario phases of the moon - fases di luna phial - fleishi phone - telefon phonograph - fonograf photo - portret piano - piano pick - 
pik - 
- 
piki picture - plachi prenchi cuadro revista pie - pastechi piece - pida djonki pieza 
- piece by piece pida pa pida in very small pieces pida-pida pig - porco porcocito 
pigeon ' duif paloma 
pile - monton hopi  pillar plumb pillar - pila 
pillow - cusinchi 
pillow'slip - slopi 
pilot - pilota stuurman loods pin - feneta 
pinch ' kinipi 
quinipi pineapple - anasa pink - rose 
pipe - 
pipa 
pipe 
tubo pipefitter - tubero 
pistol - pistool piston - piston pity 
- compadace piedad 
pity - compadace place - luga 
logar caminda 
pone plan - plan plane - 
skaaf air¬ plane avion 
plant 
' planta plant - mata planchi planet - planeta  plate - plaat plachi  plancha - 
a tajo i platina - platina 
play - hunga 
- i 
- | toca i play 
- wega | player - hungador tocadoor j 
i play-time - ora di hunga j playmate - companero compai ) plea - proceso 
i pleitu il plead - pleita defende ] please - sea asina bon si ^ bo gusta agrada 
^ pleasure - pleizier gustu ^ 
j pledge - siguridad i plenty - hopi mucho masha ^ ^ plot - 
conspiracion 
conspira tereno 
| plough - ploeg & plumb - chumbo (choom-bohb  powerless plunder - saquea plural - plural nueumonia - pulmonia 
pocket - sacu 
r.npketknife - sambetchi point - punta 
poison - veneno 
poisoned with fish shuata poisoner - venenado poisonous - venenoso 
pole ' palu 
police - policia polis policy ' policia polish - puli 
polite - cortes beleefd pollute - shusha 
pond - vijver plas 
poor - pober 
pope - papa popular - popular 
porch - veranda balcon pork - carni di porco port - puerto porto position - posicion positive - posetivo 
possess - posede 
possession - posecion propiedad possibility - posibilidad possible - posibel post - post puesto postage - stamp - stampia postcard - tarjeta postal postman - cartero post-office - postkantoor pot - wea hapa - chamber pot wea di respet pound - liber 
pour - basha drama powder - poeiru 
pulchi 
pol- ver 
power - poder 
forza autoridad power house - planta di coriente central powerless - sin poder  pox principal pox - bruera bruera sabi practice - practice 
ehercicio practice 
- practica 
haci ehercicio praise - gaba 
alaba pray - resa 
prayer - oracion - prayer- book buki misa 
preach - predica 
preacher - predikador precious - precioso 
prefer - prefer a 
pregnant - na estado em- baraza tin barika preliminary - preliminario prepare - prepara 
presnce - precencia present - 
presente 
present - 
regalo 
present 
- presenta .| regala | preside - presidi 
press - 
prensa 
pressure - presion ^ presume - suspone 
■i pretend - fingi timula | 
pretende | pretty - bonita 
prevail - domina trium- fa prevent - preveni 
previous - prome aja antes anterior 
prick - pica hinca pride - soberbia 
orgujo priest - pader prince - prins princess - princesa 
principal - principal 
principle prophet principle - principio ^ 
print - imprimi druk prints 
' zaraza prison - prison piscala rfllabus wangalan prisoner - prisonero preso private  priva scondi ketu-ketu prize ' premio first prize - premio major probability - probilidad 
probable - probable 
problem - problema procedure - procedimiento proceeds - produccion ganashi proclaim - proclama publica anuncia procure - duna haja produce - produci profane - profano blafema 
profession - profesion 
professional - profe- sional professor - profesor 
profit - ganashi 
profitable - profita- bel profound - profundo 
program - programa progress - progreso 
progresa 
prohibit - prohibi taha 
project - projecto 
promise - promesa 
primiti 

promote - promova eleva 
promoted promovi pronounce - pronuncia papia proof - prueba 
prove - proba 
propaganda - propaganda prophet - profeta  proper proper - lehitimo 
legal 
propose - propone 
proprietor - donjo 
prosper - prospera prostitute - puta 
muhe di caja muhe di bida protect - proteha protega protestant - protestant provide - duna provided that - con tal cu provoke - terg sara provoca proxy - poder - married by proxy casa pa handskun public - publico 
public holiday - fiesta popular publicity - publicidad publish ' publica pudding - pudin 
puffy - hincha 
pull - hala ranka pulley ' katrol pulpit - preekstul 
putt' pump - pomp i pumpkin - pampuna cala- bas i punch - punch | punish - castiga 
| punishment - castigu | 
capital punishment - castigo j di morto  pupil - discipulo 
popchi di wowoj purchase - cumpra 
compra | pure - puro 
| limpi i purgatory - purgatorio | purpose - doel inten- i cion obheta |j purse - portmone 
| pursue - persigi pur- | sigi 
j push - pusha stoot i puss - pushi i put - pone buta put on clothing - bisti j 
j i putty - potti stopverf   puzzle ran puzzle - charada mis- ^ terio rompecabeza puzzle 
- brua pajama - pidjama q q 
quake - tembla 
' earth quake temblor qualification - capaci- dad 
competencia 
autoriza- cion qualify - autoriza 
califica quantity - cantidad 
quarrel - pleita 
quarter - cuarto pleitu 
queen - reina 
queer - stranjo question - pregunta 
quiet ' ketu 
quit - kita trabao despacha quite - masha hopi complete r r 
rabbet - gruf 
rabbit - conenchi coneo 
rack - rekki 
racket - 
boro- to 
radish - rabanas rafter - span 
rag - lapi 
rage - rabia furia 
raid - stake invasion railroad - spoor 
rain - awa-ceru 
it rains awa ta jobe awa ta cai 
raise - alza ran - a corre 
rang recur rang - a bati 
range - clasificacion 
rank - clase catego- ria grade rare mouse - 
- raton d’je nochi rattle - maraca 
raw - curu 
razor - nabha 
safety razor - nabaha di seguridad reach - jega 
alcanza read - lesa 
- reading book - buki di lesa ready - cla kla caba real - di berda 
realize - realiza 
reap - corta to reap corn - corta maishi reason - causa razon 
rebel - motina 
rebellion - motin 
rebuke - blaas - scual 
recently - recientimente 
recent - poco tempu pasa algun tempu pasa receive - recibi 
ricibi 
recipe - recet 
reclaim - reclama recommend - recomenda record - plachi 
record 
- recorda nota recover - recoba recreation - recreacion recruit - rerkruut 
recur - socede trobe 
red remove red - corra 
redsnapper - pisca corra jesem ' salba 
redeemer - salbador reduce - mengua haci menos bira mas poco reduction - reduccion reform - comberti 
mehora 
bira bon i’efresh - fresca 
refresca refrigerator - frigidair - refrigio 
refuse - nenga 
regard - weita mira respet region - loga luga 
regret - duel 
duele 
lamenta - i regret i am sorry duel mi regular - regular regulate - regula 
reign - goberna manda rein - frena rienda reject - desaproba 
rechaza relate - conta bisa relation - puesto empleo relacion famija relationship - parente famija familia relatively - relative 
release - laga bai relief - alivio 

relieve - alivia 
religion - religion religious - religiose 
remain - keda 
queda remainder - resto sobra remarkable - remarkabel remarcable remember - corda remind - corda 
remit - manda pordona 
remove - mov cambia  renovate renovate - renova 
rent 
- skeer 
rent 
- hier 
reopen - habri di nobo reorganize - reorganiza repair - drecha 
reparation - reparacion drechamentu repeat - repiti 
repent - duele tin con- tricion arepenti repetition - repiticion repititu repitici reply - responde contesta 
contestacion 
report - raporta 
raport 
reporta informa represent - representa 
representation - repre- sentacion representative - repre- sentante rhelmatismi request - peticion 
| pidi 
i require - demanda exihi | 
exiji rescue - salba 
| reside - biha | residence - cas resi- ;| dente | resolve - resolve rest - sosiego 

sosega | retain - keda cu retene ^ retire - retira 
| retirement - retiro 
j retreat - retirada | return - bolbe | reunite - haci bon | revenge - vengansa 
| 
'i revenge - venga 
m 
| revengeful - vengativo i reward - recompensa 
- i recompensa 

rheumatism - rumatismo   ribbon rubber-mallet ribbon - cinta rich ' ricu 
- richer mas ricu - richest - e di mas ricu rico ride - subi - ride a donkey subi buricu right - drechi - right hand man drechi - to be right - tin razon ring - rinchi 
bati 
- to ring the bell bati klok rip - skeer 
kibra 
ripe - hechu 
rise ' lamta 
lamanta risk - riska 


risico rivet - remacha 
roach - kakalaka 
road ' 
caminda 
roast 
- asa roast-meat - carni asa rock - piedra baranca 
rocker - 
- wip- stul) roll - lora 

- rol 
rope - cabuja 
room - cuarto 
rooster - gai 
root - rais 
rosary - rosario rose - rosa rosebud - konopi rosy - corra - to blush - bira corra rot - putri 
rough - grof bruto 
round - rondo row 
- rij - careda 
row - 
pleitu bringamentu rub - hala frega rubbish - greis basura 
rubber - elastik las- tik rubber-mallet - martin di lastik  ruby safety razor ruby - rubi rudder - timon rude - onbeshop grocero ruffian - bandido 
ruin - ruina danja corrompi rule - regia duimstok ruler - liniaal rum - rom rumor - rumor 
run - corre camna 
- run fast - corre duro corre lihe - run slowly corre poco- poco rupture - breuk - putroos rush - pura 
rust - froestu 
rusty - yen di froestu s s 
sable - sabel 
sabotage - sabotahe 
sabota 

sack - sacu 
sacrament - sacramentu sacred - santo sagrada 
sacrifice - sacraficio sad - tristu 
saddle - sia 
- silja saddle-belt - chincha 
sadness - tristesa 
safe - 
caha di heru - 
sigur safety - seguridad - safety conscious - consiente di seguridad safety - seguridad for safety sake - pa mas seguridad safety pin - preke 
safety razor - nabaha di seguridad  sail saucer sail - 
bela 

nabiga - sailboat barcu di bela - canvas - iona sailmaker - belero sailor - matroos - marinero saint - santo 
salary - salario sueldo 
salad - salada 
sale - vendishi - bara- tiljo - bendementu salmon - salmao 
saloon - salon 
salt - salu 

salted meat - carnisa 
saiga salute - cuminda 
salvage - salba 
salve - zalfi 
bador sanction - aproba san- ciona sancion 
sand - santu sandal - sambarcu - san- dalia 
sandwich - sandwishi 
sandpaper - papel di glas skurpapier sand screen - sifta 
sanitary - sanitario sap - lechi 
sarcasm - sarcasmo 
sardine - sardinchi 
satan - satanas satin - satin 
satisfaction - satisfac- cion satisfactory - na satis- fecho saturate - satura 
saturday - diasabra sauce - saus saucer - skotter  sausage screen sausage - saucijshi save - salba 
saviour - redentor salbador say - bisa saw - zaag 
scabies - scarna 
scaffold - stelashi stengel scale - balaiiza scandal - scandal 
scandalisa 
scandalous - scandaloso scant - poco scape-goat - pagot scarce - skaars scars scare - spanta 
scarcity - skaarsidad scatter - plama 
september - september scene - toneel - bista 
escena 
scenery - bista 
scent - 
olo holo awa di olo scentless - sin olo scholar - discipulo es- tudiante scholarship - beca di estudio school - skool 
school-room - skool- lokaal school-teacher - meester meneer juf mevrouw scholastic - escolar schooner - golet science - ciencia 
scissors - sker seer scold - zundra scour - boender frega 
scout - padvinder scramble - subi grapa 
scarp - chochoria 
scrape - 
raspa 
strepi rascu scratch - 
gravata 
rascu scream 
grita 
gritu 
screen - tranke trankera  e/»rftw seriously screw ' skruf 
scrub ' frega 
sea ' laman 
sea-bath - banjo den laman sea egg - zee apel seal 
sejo 
seja 
sealing wax - lak seam - nachi cose seaman - marino marinero seamstress - cosedor 
search - busca 
sea-sick - maria 
seaside - kantu di laman seaside grapes - zee dreifi dreifi di laman season - estacion seat - bom di stul second - seconde momento segundo e di dos 
secret - secreto 
secure - sigur protega warda see - weita 
mira 
seed - simija 
seek - busca 
see-saw - wip skommel seize - cohe 
select - escoge self - mes myself mi mes sell - bende 
send - manda senior - major sense - sinti - seen- tee) tino 
sentence - sentencia sentinel - cintinela separate - parti separa divorcia serge - diagonal sergeant - sergeant serial - set cantidad 
serious - serioso 
seriously - seriosamente  shelter sermon sermon - predicashi serpent - culebra servant - cria 
sirbidor serve - sirbi service - servicio ser- bicio session - union set place - pone 
seven - siete 
seventh - e di siete 
seventeen - diez-siete seventieth - e di setenta seventy - setenta 
several - diferencia various sew - cose 
shackle - boei shade - sombra 
shadow - sombra skadu 
shake - sagudi 
shame - berguenza - to be ashame tin berguenza shameless - sin berguen¬ za shape - figura 
forma 
share - parti 
shark - tribon 
sharp - skerpi fuerte 
sharpen - mula 
haci skerpi shatter - machica 
shave - feita shaving brush - kwashi di feita she - e 
el 
shears - sker sheep - came 
- leg of mutton hapa sheet - laken 
- sheet of paper vel di papel shelf - planki 
trazjer shelter - ramada  sight shell 
- cocoli- shi 
casca 
shift - warda - 
cambia - the wind has shifted - biento a cambia shin - palu di pia 
shine - kima brija lom- bra ship - barcu bapor 
shipwreck - naufragio shipyard - dok shirt - camisa shoe - zapatu bota 
shoemaker - zapate shoestring - veter 
shoot - 
tira 
shop - tienda pacus 
shopkeeper - tendero short - corticu 
shot - tiru 
tiro shoulder - skouder 
shout - grita 
shovel - skop schop show 
munstra show off - broma shrink - krimp shrimp - cabaron shun ' evita 
shut - 
cera cera 

shy - skiu 
schuw sick - malu 
enfermo sickness - malesa 
enfermedad side - banda costia rightside banda drechi sigh - 
suspisa 
suspiro siege - sitio sieve - sifta zeefte sight - bista 
sigh sign - senja senyal 
firma silence - silencio silent - ketu 
silk - seda 
silly - bobo 
- inocente simple - simple 
sin - pica 
- pecado 
since - desde foi - since when foi ki dia sincere - franco sin- cero sing - canta 
singer - cantador sink ' hundi 
- fundi 
sink sinner - pecador 
syrup - strop! sister - ruman-muhe ruman-mohe sister-in-law - cunja 
sit - sinta 
six - seis sixth - e di seis sexto sixtieth - e di sesenta sixty - sesenta size - tamanjo grandura skillful - apto capabel skin - cuero 
skip 
salta 
skirt - saya saja skull - cabes 
sky - cielu 
den laria 
firmamentu slack - los slap - bofta 
slate - lei slave - catibu 
slay - dal mata 
sleep - drumi 
sleepy - tin sonjo sleeve - manga 
slide - slip 
slight - poco slip - slip  r slippery_something slippery - lebe^ebe 
slit " sneechi 
slope - skeins slow - poco-poco since - sluis small - childtu 
smart - sabi 
smash - kibra 
smell 
hole 

olo smile 
sonrisa 
sonree smith - smid smoke - huma 
smoked herring - bok- kel smoker - humador smuggle - smokkel - contrabanda snake - culebra 
sneeze - niester snore - ronca 
snow - sneeuw snuff - snuif snug - gezellig so - asina - so much asina tanto soak - doop moha muha so 
- di manera cu soap - habon 
social - social sock - sok society - sociedad sofa - sofa soft - moli suave 
soil - susha soldier - solda solicit - solicita 
solid - duro 
firme solitary - solitario solitude - solitudo some - algun 
- sometimes algun be somewhere algun luga algun camina somebody - algun hende something - algo 
sometimes spoil sometimes - algun biaha son - jiu bomber son-in-law - suegro song - cantica cancion 
soon - tempran pronto sore - haci 

sorrow - duel tristesa 
sorry - tristu 
sort - sorto - all sorts tur sorto soul - alma sound 
- zonido 
sonido 
sona soup - soppi 
soup-plate - tajo di soppi soup-spoon - cucharra di soppi sow 
- planta space - espacio 
spade 
- chapi 
spanish - spanjo spare 
- reserba 
delega spar - chispa* 
sparrow - mofi spasm - kramp stuipi 
speak - papia 
speaker - papiador ora- dor special - special 
specialist - specialista speech - discurso papia-. mentu 
speed - velocidad spell - spel spend - gasta 
spider - aranja haranja spill - plama drama spin - wesu di lomba spirit - spiritu - holy spirit - spiritu santo spit - scupi 
spite - rencor 
splash - spat plama 
spoil - danja  split step-mothea: split - parti splits (keer 
sponge - spons sponsor - padrino pad- rina sponsored by abao aiis- picio di sport - sport spring 
- prima- vera spy - spion square - cuadra 
cuadrado squat - jongota squeeze - primi 
stab - hinca mata 
stage - stelashi 
stagger - trompica 
stain - mancha stairway - trapi 
stair - tred di trapi stale bread - pan bieu stamp - stampia stand - para 
star - strea 
stare - keda mira 
stark naked - bio sunu start - cuminsa cumin- za 
starve - muri di hamber state - estado condi- cion station - stacion warda stay - keda - stay at home keda cas 
queda steal - horta 
steam - stoom vapor 
steel - staal step - trapi 

trapa paso step-child - entena 
step-father - padrasa step-ladder - trapi 
step-mother - madrasa 
stick subject stick - palu 
pega 
- walking stick garoti sticky - pega-pega - cu ta pega stiff - stijf duro stimulant - estimulo sting - hinca pica stink - hole stinki stitch - steek 
stocking - mea 
stomach - stoma 
stone - piedra 
stone wall - muraja di piedra stop - stop para 
stoop - buk store 
- reserba 
store 
- pacus 
storm - stormo story - historia cuenta stove - stoof 
straight - derechi 
strand - kantu di laman strange - stranjo raar stranger - stranhero 
stray 
- perde camina 
straw - cabana stream - stroom 
street - caja 
strength - forza - to be strong tin forza strike 
dal welga huelga 
golpea 
string - cabuja fini strong - fuerte sterki to be strong tin forza struggle - lucha 
student - estudiante 
study - sinja studia 
stuff - stof panja tela stumble - trompica 
stump - troncon 
subject - asunto 
succeed surprise succeed - logra sali bon sherta 
success - exito 
suceso such - tal 
suck - chupa 
sucker - chupador sue - persigi 
pursigi suffer - sufri 
sufficient - basta bastante sugar - sucu 
sugar-candy - cos dushi coi dushi suggest - propone 
suggestion - sugerencia suicide - mata su mes curpa suit - fluz flus 
sulphur - azufra sum - som suma summer - zomer verano summon - dagvaar sunday - diadomingo 
sun - solo - the sun shines hot solo ta kima sunrise - salimentu di solo sunset - drentamentu di solo sun-shine - luz di solo superior - superior supper - cena 
supervisor - hefe 
forman superin- tendente supply - entrega 
support - mantene 
soporta suppose - supone 
supreme - supremo 
sure - sigur 
surface - ariba surpass - surpasa surprise - sorpreso keda admira keda asombra sorprende  surrender tamarind surrender - capitula duna op derota suspect - sospecha suspend - colga 
suspicion - suspicion sosposicion sustain - mantene sostene swallow - zouchi 
guli 
swear - hura 
jura suspenders - guiel 
sweat - 
sodo 
soda sweet - dushi - sweatheart dushi galinja namorada amante sweets - cos dushi 
sweep - bari swell - hincha 
swift - lihe 
swim - landa 
swine - porco 
swing " skommel sword - sabel 
spada syllable - silaba symbol - simbolico sympathy - simpatica 
synagogue - snoa syphilis - sifilis 
system - sistema 
systematic - sistematico t t 
table - mesa 
table 
- tafia 
tack - ruigi - clabu chikitu 
tail - rabu 
tailor - snyro snijer take - tuma cohe 
tale - historia 
tale 
- caweta redador 
talk - papia 
combersa talking pictures - cine parlante tall - haltu largu 
tamarind - tamarijn  tame thicket tame - mansu 
tamper 
- mishi cu 
tank - tanki 
tanker - tankero tanquero tanner - curtido tape - cinta 
tar - breu 
teer tardy - laat tart - bolo 
taste 
smak 
purba tax - belaster belasting 
taxi - taxi tea - te 
teapot - canica di te teach - sinja 
team - elftal teem 
tear - 
kibra 
lacrima 
tease - tenta 
technical - tecnico tell - bisa conta 
temporary - temporario ten - diez 
tenth - decimo e di diez tend - sirbi tennis - tennis term - termino 
terminate - termina 
termination - termina- cion terror - miedo 
test - test 
thank 
gradici thanks danki 
that - esei esaja thatch - cabana 
the - e es 

theatre - cine teatro 

theft - ladronicia their - nan theirs di nan them - nan 
there - aja 
therefore - pa'sei there in - pa den thick - diki 
thicket - biljete kaarchi  thief tin smith thief - ladron - thieve 
horta thimble - vrengud thin - delega thing - cos - something algun cos - everything tur cos think - pensa 
kere 
third - tercero e di tres thirst - sed - to be thirsty - tin sed this - easki 
e.aki thorn - spina 
sumpinja those - esnan esajanan though - aunke maski 
thought - pensamentu 
this - esaki csaki) this 
- awe tardi 
this 
- awe mainta 
this 
- awe nochi 
threat - amenaza through - door throw - tira 
thumb - dede grandi 
thunder - bos strena 
thursday - diahuebes 
ticket - kaarchi bil- jete ticking 
- tyk tickle - kishiki 
tidy - nechi 
tie - 
dashi 
tie - 
mara 
tiger - tigro 
tiger 
tight - preta 
tile - panchi 
till - te 
tiller - canja di timon time - tempo - what time is it? ki ora ta? tin - bleki tin smith - blequero  tiny traitor liny - chikitu fini tipsy - burachi 
tire - taja 
tired - cansa fatiga 
title - fam 
to - na 
toad - sapu 
dori 
tobacco - tobaco 
today - awe tonight awe nochi to-morrow majan toe - dede di pia tomato - tomati to-morrow - majan 
tone - sonido 
tongs - pens tongue - lenga 
tonight - awe nochi 
tool - herment toolbox - caha di herment tooth - diente 
top - punta 
tromp torpedo - torpedo 
toss - tira 
tortoise - morcoy total - total touch - mishi 
toca 
tourist - turista tournament - torneo tough - duro taai tour - paseo towel - servete 
serbette town - stad playa toward - den dirrecion di toy - cos di hunga 
trade - ofishi 
tragedy - tragedia train - trein 
train - 
train 
training - entranementu traitor - traidor  tramp turtle tramp - trapa 
transaction - transacion transfer - transport 
transit - transito 
translate 
- traduci translation traduccion transmit - hiba 
transport - transporta trap - val trash - basora 
travel - viaja 
tremble - tembla 
trench - trinchera 
trial - prueba experimento trifle - bagatal cos di nada 
trip 
- camna chikichiki trip - camna chikichiki trompeca 
tropical - tropical troop - tropa trouble 
- molesto 
molester truck - 
carson 
truck - 
camejon truck true - berdad - it is true ta berdad trust - confia (kon-fee- truth - berdad 
ah) try - purba pruba 
tub - tobo 
tube - tubo 
tuesday - diamars 
tulip - tulipan tumble - cai 
tune - wijs melodia 
turkey - calacuna 
turn - bira 
turnip - konolchi turtle - tortuga - tortoise morcoi  twelfth underhand twelfth - e di diez-dos twelve - diez-dos 
twig - rama 
twin - ohochi 
twine - cabuja fini twist - drei bira 
troce two - dos 
twofold - dobbel typewriter - mashin di skirbi type 
- skirbi na mashin u u 
u-boat - submarin 
ugly - mahos 
ulcer - postema 
ultimate - ultimo 
umbrella - parasol 
unaccepted - ninga 
unaided - sin judanza 
unaltered - sin cambio 
unashamed - sin verguensa 
unaware - sin sa 
unbeliever - pagano 
unchaste - imoral 
unclad - sunu 
uncle - oom 
tio 
unclean - shushi 
uncomfortable - descom- fortabel 
uncommon - stranjo 
unconscious - sin sa 
foi tino uncovered - sin tapa under - abao 
bao under 
- bao di pena di morto underhand - abao di man  undershift us undershirt - flanel flah-nel) underneath - abac 
underpants - carsoncillo undersign - firma understand - comprende 
undo - los undress - kita panja uneasy - desagradabel 
unfair - inhustu 
unfairness - inhusticia 
unfit - no sirbi no bal incompetante in-capas unfriendly -impopular - grosero unhappy - infeliz unhealthy - infermiso 
unhook - los unite - uni 
uninjured - sin danjo 
union - union unit - unidad unite - hunta 
uni 
unless - sin 
unlucky - sin suerte no tin suerte unpack - saca 
unpaid - keda sin paga unrest - agitacion 
unripe - berde 
untrue - ganja 
up - ariba 
upon - ariba riba upper - mas ariba upset - tira abao 
urgent - urgente 
urine - orina 
urinate - orina 
us - nos 
use victuals use ' usa 
useful - util 
utensil - herment v v 
vacancy - vacant 
bashi 
vacation - vacantie 
vaca- cion vagabond - bagamundo 
vain - vano 
vale - dal 
valid - lehitimo 
valido 
valour - wapu 
balor 
value 
- balor 
balua vanilla - vanija 
vanish - desparce 
somenta vanquish - triumfa 
variety - variacion various - varios 
varnish - vernis vary - varia 
vase - vaas 
flo- rero veal - carni di bise vegetable - berdura 
vehicle - vehiculo 
veil - vaal 
vein - bena 
velvet - felpa 
vengeance - vengansa venture - risca 
riska 
risico 
vessel - vasija vest - shilet vial - fleishi vicar - vicario viceroy - virey victory - victoria victuals - cuminda 
victory wait victory - victoria view - bista vista villa - villa violet - lila 
violeta violin - viool violin 
- cuerda violin 
- strijkstok virgin - birgen mosa virile - machu fertil 
verility - hombresa 
vision - vision bista visit - 
bishita 
bishita 
visitor - bishitante vocation - vocacion vocational 
- skool di ofishi vogue - moda 
voice - voz boz stem void - bashi anula 
volcano - volcan volume - contenido 
volume 
- tomo 
vomit - saca 
vote - vota bota 
voter - botado 
votador vow - promesa 
voyage - biaha viaje vulgar - shushi vulgar obseno w w 
wage - sueldo 
wage 
- agrupa- mento di sueldo wage and salary division - division di sueldo y salario waggon - wagon 
wail - jora 
waist - centura 
wait - warda para spera - wait for me warda mi - wait a moment - spera un momento  watch r i waii waiter - serbidor mosa wake - lamta lamnta walk - camna walk fast camna duro camna lihe walk slowly camna poco-poco wall - muraja 
wallet ' portmone 
wander - camna rond want - kier ke 
tin mester war - gera guera 
ward - cuarto 
warden - cipier 
wardrobe - kashi di panja warm - calor it’s warm - ta haci calor warn - avisa 
warrant - poder 
warship - barcu di gera 
wart - fret wary - protehoso 
was - tabata 
tawata 
wash - laba 
washboard - washi 
wash-basin - palangana 
washing stand - was- tafel washtub - tobo di laba panja ponchera wasp - maribomba 
waste - gasta 
malgasta watch 
- oloshi 
watchmaker - relojero watch 
- weita mira  watchman weight watchman - wachi 
water - awa - holy - water awa bendicta waterbottle - garafi watercan - fogon 
water edge - kantu di awa water-glass - glas pa awa - glass of water glas di awa watermelon - patia waterpipe - tubo di awa - waterleiding water-spout - hoos 
water-tank - tanki di awa water-tap - kranchi watery - awa-awa wave 
- ola wave 
bula - 
wax - was way - caminda 
weak - zwak - debil 
weaken - bira zwak weakness - debilidad 
wealth - rikesa 
wealthy - ricu wear - bisti 
weariness - cansamentu weary - cansa fatiga 
weather - tempu 
wed - casa wedding - casamentu wedding-cake - bolo di casamentu wedding-day - dia di casamentu wedge - wei spie (spee wednesday - diarazon 
week - siman - next week otro siman - last week siman pasa week-day - dia di siman week-end - fin di siman weekly - pa siman weep - jora 
weigh - pisa 
weight - peso 
wslcoms whooping-cough welcome - bon bini well - bon salu 
well 
-poz well-being - bienestar well-bred - decente 
well-off - ricu went - a bai a sail were - tabata tawata west - banda abao west wet - muha moha - down wet papa muha whale - bajena 
what - kiko - quico kee-koh) whatever - kiko e ta wheel - wiel 
when - ki ora ki dia ki anja ki tempu whenever - en cuando whence - di unda where - unda 
wherefore - pa kiko pa e motibo whereas - mientras wherein - di kiko den cual 
where-on - riba kiko - riba cual whereto - pakiko - na unda which - cual cua which ever - cualke calke while - mientras 
a while - un ratu 
whip - shwiep whistle - fleit white - blancu white cotton - bogo- tano white lead - loodwit whitsunday - pente- coste who - ken quen kende whole - henter tur 
wholesale - major whooping-cough - kink hoest  why whitsunday why - pakiko choo) wicked - mal corrompi wide - hanchu (han- danja widow - bejuda bijuda widower - bejudo width - hanchura 
wife - casa senjora esposa wild - brabu 
feros feroso salbahe wilful - cafeesura 
will 
lo - good will bon volutad - last will testament wise - sabi 
win - gana winch - wins wind 
- bientu wind 
- bira - duna cuerdo window - bentana window glass - glas di bentana wine - binja 
wing - ala 
wink - kinipi wowo winner - ganador winsome - carinjoso winter - winter invier- no wipe - limpia seca 
wire - waja 
wireless - marconi wisdom - sabidura 
wise - sabi 
wish - deseo 
- 
desea wishful - anhela antoha desea witch - brua 
witchcraft - bertu 
with - cu 
withdraw - saca 
within - pa den 
without - sin 
witness - testigu 
whitsunday - pinkster  writing book wife ^ife - casa senjora esposa 
wolf - lobo 
woman - muhe mohe 
womb - matriz 
wonder - milager - mila- gro wood - palu 
madera 
wood-louse - comehein wooden - di palu di madera di tabla wool - lana 
word - palabra 
work 
- trabao 
obra work 
- traha 
workman - obrero tra- hador world - mundo world-war - gera mundial world-wide - den henter mundo worm - wanga - bichi 
worn - bisti - gasta worry - preeupacion worse - pio 
peor worse and worse - di malu na peor worship - adora respti honora worshiper - adorador worth - bal 
wound - herida 
wrap - lora den papel wrath - rabia odio wreath - krans wreck - wrak wrench - jabi 
wring - troce 
wrinkle - machica wrist - pols wrist-watch - pols orlo- shi write - skirbi scirbi writer - autor scirbido writing book - skrif  wrong zealously wrong - robes malu to be wrong - no tin razon wrote - a skirbi x x 
xray - xrayo y y 
yacht - jot yam - jams 
yard - jarda 

yard - cura 
year - anja 
ano yearn - tin gana tin gustu yeast - gist yell - grita 

gritu 
yellow - geel 
yes - si 
yesterday - ajera 
yet - ainda 
not yet - ainda no yoke - span you - boabo boso bosonan young - jong hoben joven - young man - joven mosa your - bo yours - di bo 
yourself - bo mes 
youth - hubentud joventud z z 
zeal - ijver zinc - zinc zealously - zelosamente  papiamentu-english section in this section aternate spellings of words are indicated. for example: crus cruz. words in brackets other than the pronunciations should precede the word listed. for example: macacu 
should read ’’cos di macacu” - mimicry. this also applies to similar expressions in the english-papiamentu section. ah - aye ai - eh ee - ei oh -  - short vocalic sound as in father long vocalic sound as in name maintain short sound of e as in step long vocalic sound of e as in me knee long vocalic sound of i moderated as in english oh sound of  in moon personal pronouns a synopsis of the principal rules with examples and pronunciations which will assist english-speaking people to acquire a fair knowledge of papiamentu: i - mi 
; ami 
you - bo 
; abo 
; ami and abo are used instead of mi and bo when emphasis is required he she it - e 
is accented when written as a small letter to distinguish it from ’’e’’ 
the definite article. el is used instead of e in some situations for the sake of euphony. we - nos 
they - nan 
you 
- boso bosonan possessive pronouns my - mi; mine - di mi 
your - bo; yours - di bo 
his her its - su; his hers its - di e di je our - nos; ours - di nos 
their - nan theirs - di nan 

examples: my book - mi buki 
it is mine - e ta di me 
your hat - bo sombre 
it is yours - e ta di bo 
his house - su cas it is his - e ta di je 
her dress - su bisti 
it is hers - e ta di je 
our house - nos cas 
it is ours - e ta di nos their car - nan auto 
it is theirs - e ta di nan note: the possessive pronouns are identical with the pronouns except his her and its - su 
. personal articles the indefinite article or ^^an^^ is im rnnn'i *. article ’’the” is e. sometimes es is used for the sake of euphony^ verbs to be - ta. ta signifies am is and are examples : mi ta malu 
- i am ill bo ta salu 
- you are healthy 
e ta ricu 
- he she it is rich nos ta pober 
. we are poor n ta contento 
- they are glad (tah^ithtm 
or tawata uan-wan-tah) - was were. examples: i was rich - mi tabata ricu you were poor - bo tabata pober to have 
- tin i have books - mi tin buki 
thev^^itif sombre 
n ?? ■ teen aw-toh)^ the past tense of tin is tabatin or tawatin 
. examples: mi tabatin pan 
- i had bread form conjugate verbs in the present tense. the simple form and the continuous form are identical. i eat or i am eatine koh-may). you drink or are drinking? bo ta bebe 
. uzmxmg past continuous form i was eating - mi tabata come you were drinking - bo tabata bebe simple past tenses i ate or i have eaten - mi a come 
you drank or you have drunk - bo a bebe 
future tense i shall come - lo mi bini 
we will go - lo nos bai 
john will sing - juan lo canta 
note: when the subject of the sentence is a pronoun lo precedes the subject; when a noun it is placed after the subject - 
. the future is in most cases expressed by the simple present tense as is also done in english - i am going tomorrow - mi ta bai majan 
. sentences there are three kinds of sentences as in other languages. declarative 
interrogative 
and nega¬ tive sentences. interrogative sentences are identical in sentence structure with declarative sentences. negative sentences are formed by placing in front of the verb. examples i go or i am going - mi ta bai am i going? mi ta bai? i’m not going - mi no ta bai 

the verb do - haci - is not used in papiamentu as an auxiliary verb. verbs with which ta is not used: por 
- may - can. mi por bai cas - i may go home. bo por papia papiamentu? - can you speak papiamentu? mester 
bo mester bai - you must go. sa or sabi - know. bo sa mi nomber? do you know my name? mi n’sa 
- i don’t know. kier 
- want. mi kier placa 
i want money. ki bo kier? 
- what do yau want? expressions in which ’’tin” is used instead of ”ta”. i am hungry - mi tin hamber you are thirsty - bo tin sed 
john is afraid - juan tin miedo 
mary is strong - maria tin forza 
we are sleepy - nos tin sonjo 
they are right - nan tin razon 
key to pronunciation possessive case there are two ways to express ownership. the book is peter’s - e buki ta di pedro 
it is peter’s book - e ta pedro su buki * plural of nouns the plural is formed by affixing nan to the singular. when nouns are preceded by words denoting quantity the plural form is not used. examples mi tin dos dashi 
- i have two ties cuanto buki bo tin? - how many books do you have? mi bukinan ta nobo - my books are new adjectives adjectives in general are placed after the nouns they qualify. there are a few however which precede the nouns: bon - malu - grandi with a difference in meaning. un bon homber - a good man un homber malu - a sick man un mal homber - a bad man un cas grandi - a large house un gran homber - a great man note: grandi and malu become gran and mal when preceding the nouns they qualify. degrees of comparison i’m rich - mi ta ricu 
you are richer - bo ta mas ricu 
john is the richest - juan ta e di mas ricu 
exceptions: bon miho mas miho malu peor 
mas peor. demonstrative pronouns esaki 
this - abbreviated to saki this is my pen - saki ta mi pen esei 
- that that is your shirt - esei ta bo camisa esaja 
- that that is your house - esaja ta bo cas when used as adjectives they are disjointed and s is omitted. this book - e buki aki that house - e cas ei that car yonder - e auto aja interrogative pronouns ken quen - who? di den or ken su - whose? ki kiko - what? di kiko - of what ? relative pronouns who whom - cu kende other uses of eu 
cu - with. mi ta bai cu bo - i’m going with you cu - than. mi ta mas bieu cu bo - i’m older than you cu - as. mi ta mes bieu cu bo - i am as old as you cu - that. e a bisa cu e ta bini - he said that he is coming adverbs are placed at the beginning or end of sentences mi ta bini majan - i’ll come tomorrow majan mi ta bini - tomorrow i’ll come current expressions good day good morning - bon dia 
how are you sir miss madam? - com bai sohn? 
i m well thanks - mi ta bon danki 
i m a little ill - mi ta poco malu 
good afternoon - bon tardi 
good night good evening - bon nochi 
bo 
whats your name? - com bo nomber ta 
my name is peter - mi jama pedro (me yah-mah pay-drohi my name is peter - mi nomber ta pedro 
where do you live? - unda bo ta biba? 
i m eight years old - mi tin ocho anja 
give me - dunami 
nami 
bring me - trece pa mi 
or trecemi 
lend me - fiami 
listen to me - scucha mi 
wait for me - warda mi 
spera mi 
excuse me - dispensa mi 
come up - subi 
go up-stairs) - bai ariba 
go down - baha 
be quiet - keda ketu 
open the door - abri porta 
uose the door - cera porta 
come here - bini aki 
wait a moment - spera un momento 
take care - tene cuidao 
stay here - keda aki 
go on - sigi sigui 
don’t go away - no bai 
let us go - larga nos bam 
come in - drenta 
look at tbis - mira saki 
hurry up - haci libe 
go out - sali 
wbat’s tbe matter? - ki falta? 
wbat do you say? - ki bo di? 
wbat do you want? - ki bo ke? 
wbat is that for? - pakiko esei ta sirbi? 
do you know bim? - bo conoce 
i don’t know bim - mi no conoce 
let us see - larga nos mira 
let us see - larga nos weita 
i believe so - mi ta kere asina 
it is true - ta berdad 
it is not true - no ta berda 
without doubt - sin duda 
you are wrong - bo no tin razon 
all right - ta bon 
many thanks - masha danki 
don’t mention it - no tin pakiko 
don’t mention it - no ta nada 
what’s it? - ta kiko ta? 
are you sure? - bo ta sigur? 
very sure - masha sigur 
i understand - mi ta comprende 
with great pleasure - cu much gusto 
as you like - manera bo kier 
how late is it? - cuant’or ta? 
it’s three o’clock - ta tres’or 
it is two-thirty - ta dos or y mei 
grammar the rain falls - awa ta cai 
it is raining - ta jobe 
the sun is shining - solo ta kima 
to dance at one’s piping - manera muziek ta bai asima mester balia an empty bag can’t stand - sacu bashi no por para 
live and let live - biba laga biba 
if you have glass windows don’t throw stones - si bo tin hotter den camina bo no mester tira piedra the bucket goes to the well once too often - ta jega un dia cu buricu ta cansa di carga too many irons in the fire - si bo hasa dos conijnchi na mes momentu un mester kima promise is debt - primiti ta debe mr. lend is dead - shon fia a muri strike while the iron is hot - ora heru ta cayente larga strika money rules the roost - placa ta jabi cu ta habri tur porta money makes money - placa ta jama placa what you sow you will reap - es cu bo planta bo ta cohe to take away a person’s wife or sweetheart - corta orea 
what are you looking for? - ki bo ta busca? 
take a seat - sinta 
i am in a hurry - mi tin pur a 
don’t forget - no lubida 
goodbye - ajo 
; adios do you speak papiamentu? - bo ta papia papiamentu? 
may i go home? - mi por bai cas? 
here you are - ata 
how much does it cost? - cuanto e costa? 
twenty guilders - binti florin 
it’s worth nothing - e bal nada 
he’s a sissy - e ta mariku 
it is dinner time - ta ora di come 
give me a lift - nami cabez di boto 
he left the job without permission - el a bula pipa 
hidden love is lost time - amor scondi ta tempu perdi 
aai aceptabel a aai 
- to stroke caress fondle abao 
- below under low abdica 
- abdicated abdica 
- abdicate 
abdicacion 
- abdication abe maria 
' exclama¬ tion such as ’’great heavens” abnormal 
- abnormal abogado 
- lawyer aboli 
- abolish abolicidn 
- abolish¬ ment abominabel 
- abominable abona 
- subscribe abono - bonus abonnement 
- subscription aborta 
- abortion miscarriage aborto 
- abort miscarry abri habri 
- to open absolucion 
- absolution absolutamente 
- ab¬ solutely absorba 
- to absorb absurdo 
- absurd abundancia 
- abundance academia 
- academy acceptacion - acceptance accion 
- action deed acentuacion 
- accentuation acepta 
- to accept aceptabel 
- acceptable  acera acusador acera 
- side-walk acerca 
- near close by beside acerca 
- to approach come closer acesorio 
- part of belonging to accessory acido 
- acid acido muriatico 
- muriatic acid acido sulfurico 
- sulfuric acid acolada 
- accolade acomoda 
- accomodate acomplecimentu - accom¬ plishment acta 
- minutes deed actitud 
- attitude actividad 
- activity active 
- active acto 
- deed act acto di fe 
act of faith acto di contricion 
- act of contrition actor 
- actor actriz 
- ac¬ tress actual 
- ac¬ tual actualmente - actually actualidad 
- actuality acuario 
- aquarium acuerdo 
- accord agreed to acumula 
- accumulate acumulacion 
- accumulation acuse 
- to accuse to blame acusacion 
- accusation acusador 
- accuser  adelanta adversano adelanta 
- to progress to go forward ademas 
- besides in addition to ademas di
- besides aden 
- in in the adequa 
- ade¬ quate adequadamente 
-adequately adilante 
- forward go on administra 
- administer administration - adminis¬ tration administrador - adminis¬ trator administrativo - adminis¬ trative admira 
- to admire admirabel 
- admirable admiral 
- admiral admisibel 
- admissable ac¬ ceptable admision 
- admission admit! 
- to admit adopta 
- to adopt adora 
- to adore to worship adorabel 
- adorable adoracien 
- adoration adorador 
- adorer wor¬ shiper adorna 
- to adorn adres 
- ad¬ dress adresa - to address advent - advent adversano 
- adversary op¬ ponent  afeccion ajera afeccion 
- affection afectuoso 
- affec¬ tionate affliccion 
- affliction sorrow afirma 
- to affirm affirmed 
confirm afirmacion 
- affirma¬ tion conformation afirmativo 
- affir¬ mative afligi 
- to afflict to sadden afortunamente - fortu¬ nately africa 
- africa africano 
- african agencia 
- agency agente 
- agent agonia 
- agony agricultura 
- agri¬ culture aguila 
- eagle ai 
- oh ainda 
- still yet aire 
- air aire condicionado - air conditioned aja 
- there ajabanda eibanda 
- that way over there ajabao eibao 
- there under underneath below ajaden eiden 
- in there there in ajatras eitras 
- behind there ajera - yesterday - ajer- tardi yesterday after¬ noon - ajermainta yes¬ terday morning - ajer- nochi - yesterday evening or night  alma di dios aio ajo adios - bye good-by ajuda 
- to help aki aqui 
- here aki cerca - near here close by aki den - here in in here aki fo - here out aki riba - here on up here ala 
- wing alaba 
- to praise alabanza 
- r.c. evening service. benediction alafin 
- at last alameda 
- park alaso 
- prick stab album - album alcanza 
- reach obtain get overtake alcapara - child's hood alcohol - alcohol alcontrario - to the con¬ trary alegria 
- joy mirth alein 
- alum aleman 
- german alemania - germany alerta 
- to be alert 
alert quiet aletria 
- vermicelli algu algo - something algun tempu pasa - some¬ time ago aliado 
- ally alianza 
- allegiance alimentu 
- food victuals alivia 
- to soothe to air to relieve alma 
- soul alma di dios 
- good old soul  a lo largu aniset a lo largu - in the long run alomenos 
- at least alpargata - slipper 
altar 
- altar altitud 
- height al¬ titude amabel 
- aimable loving amandel 
- date 
ambos - both amen 
- amen america 
- america americano 
- american ami - i 
amiga 
- female friend amigu 
- male friend amistad 
- friendship amor 
- love darling sweetheart amor propio - self-love amputa 
- amputate analisa 
- to analyze anatomica 
- anatomy anchovis - anchove aneha 
- gasp longing desire to hanker after long for anemia 
- anemia angel - angel angel wardador - guardian angel anhelo 
- anima 
- to encourage animate in¬ spire animacion - animation animal 
- cheerfulness alacrity animal animo 
- en¬ thusiasm zest spirit amis 
-anis aniset - anisette  anja apreciabel anja 
- year anja nobo - new year anja pasa - last year anker - anchor anochi 
^ at night anonimo 
- anonymous ansha 
- an¬ xious anshamentu - anxiety antajera - day before yesterday antes - before formerly antija 
- antilles anto (ahn-toh - then antoha 
- to desire long for anula 
- annul to become void anulacion - annulment annal - annual anuidad - annuity anunciamentu - announ¬ cement anuncio - advertisement announcement anzue 
- fish - hook aparato 
- apparatus camera aparicion - apparition spirit ghost aparta 
- to take apart apel 
- apple apela 
- to appeal apelsina 
- orange apenas 
- hardly scarcely apendicitis - apendicitis apendis 
- appendix aplausa - applause applicante - applicant apostel ^ apostle apostolico - apostolic aprecia 
- to appraise esteem respect apreciabel 
- praiseworthy  aprecio atardi aprecio 
- esteem regard respect april - april aproba 
- to approve aranja haranja spider ararut 
- arrowroot arcangel - archangel arco 
- ark area - area argumento - argument ariba - above on the top of ariba abao - upside down arkitect 
- architect arma 
- arms arma 
- armed aroplane - airplane aros aroz - rice arrest - custody arrest arrestant - arrested person prisoner arte - art articulo 
- article artificial 
- artificial artileria 
- artillery artista 
- artist arubiano - aruban asalta 
- to assault asbak 
- ashtray asbesto - asbestos aseguro 
assure asesino 
- assasin murderer asfalt - asphalt asia 
- asia asiatico - asiatic asina 
- so thus asina cu so that aspecto - feature aspect asumpcion - assumption ata - here it is see there ataca 
- at¬ tack atardi 
- afternoon  atencion awaceru atencion 
- attention atende 
- to have at heart atraccion 
- attraction atrao - attract atras 
- behind atrasa 
- backward behind atrobe 
- again auditorio - auditorium augusto - august aumenta 
- to increase aunke 
- though although ausencia 
- absence ausente 
- absent australia - australia autentico 
- authentic austria - austria austriaco - austrian auto 
- car automobilista - cardriver autoridad 
- authority autoriza 
- authorize empower avance 
- ad¬ vance avanza 
- to advance aviador 
- aviator avisa 
- to advise aviso 
- ad¬ vice avocati - alligator pear awa 
- water awa-bendita - holy water awa di ball - drain water awa di colonia - cologne awa di jobe - rain water awa di olo - perfume awa di plaja - fish-soup awa dushi - fresh water awa jen - high tide awa secu - low tide awaceru - 
- rain  awasa baheza awasa 
- saltwater awe 
- today awenochi 
- to-night awendia 
- presently awor 
- now aworo 
- by and by presently azeta 
- oil b b 
baai 
- bay baas 
- boss baba 
- to drivel babado 
- driveler slobberer babel 
- fuss racket noise babuca 
- surprised astonished baca 
- cow bacaduro 
- beetle bachi 
- jacket coat bacoba 
- bacove 
bacteria 
- bacteria germs bagamundo 
- a good for nothing bagas - chaff husk bagatel 
- trifle baha 
- get down take down descend demote baha cabes - to acknow¬ ledge one’s fault baha man - to take less to lower one’s hand baha na awa - to launch baha na tera - to go ashore bahado 
- end termination bahamentu 
- descent slope incline decrease baheza 
- lowness m.eanness base¬ ness  baho balia disfraz baho 
- low mean bahul 
- chest trunk bai 
- to go bai cas - go home bai dilanti - go in front go forv/ard bai dril - go away bai leu - to go far to faint bai na polchi - go to blazes go to hell bai pisca 
- go away be gone make a fool of your grand¬ mother - go fishing full of prunes bailarina 
- ballerina bajena 
- whale bajete 
- flannel bajonet - bayonet bake 
- expert baki 
- through cistern bakijao 
- cod-fish bai - fit worth - e auto n’ bai nada the car is no good bala 
- bale balabonchi 
- lump a swel¬ ling balander 
- sloop balandrin - a lady’s wide skirt balanza 
- to balance balaster 
- balau - sword-fish ballast balchi 
- meat-ball balcon 
-bal¬ cony porch baldadi 
- wanton mischievous balente 
- sturdy buxom good balia 
-to dance balia disfraz - masquerade dance  baliado baratijo baliado - dancer baliamentu - dance balinja 
- sheath scabbard balki 
- beam balor 
- value balota 
^ to vote cast a ballot balsem - chewing gum balsema 
- to embalm balua 
-to value baluador - estimator banal - trivial banana 
- banana banda 
- side music band banda ariba - east banda abao - west banda di - beside banda di cara - cheek bandera 
- flag bandido 
- bandit bandona 
- to abandon banja 
- to bathe banjo 
- bath bankero 
- banker banki 
- bench banko 
- bank bank roet 
- bankrupt bao di - under beneath bao di condicion - under conditions bao di huma - misty bao di nubia - under the clouds bao di pena - under punishment bapor 
- steam¬ ship bapor di carga - cargo boat bapor di gera - warship bara 
- stave bar stick baraba di carta - a deck of cards baranca 
- rock cliff barata 
- inexpensive cheap baratijo baratillo 
- cheap sale  barba baster barba 
- beard chin barbara - barbarous barberia 
- barber-shop barbero 
- barber barbon - a man with a beard barbulete 
- butterfly barca 
- to ship barcu 
- ship vessel barcu di bela 
- sail ship barete 
- staff bari 
- to sweep barica 
- belly abdomen baricade - barricade barigonchi 
- fat belly barometer - barometer barril - barrel basa 
- based base 
- base basha 
- to spill to pour basha 
- poured spilt basha abao - to break down pull down demo¬ lish basha aden - fill in pour in basha over - to overflow to run over bashi 
- empty basico - basic basora 
- broom rubbish basora chikitu - whisk- broom basta - enough plenty basta bieu - aged elderly bastante - sufficient enough baster - to burst to crack  bata belga bata - child’s dress bataja 
- battle batata 
- potato batata dushi - sweet potato bateria 
- battery bati 
- to strike hit bati klok - to ring the bell bati lechi - to churn milk bati man - to clap hands to applaud bati pia - to stamp bati tambu - to beat the drum batimentu di man - applause batisa 
- to baptize batista - batiste lawn haul 
- trunk bautismo 
- baptism bazar - bazaar be bez bes - times bebe 
- to drink bebe burachi 
- to drink to excess intoxicated bebe fuma 
- to become intoxicated bebedor - drinker bebida 
- drink bedei - to point out beis - humor beitel - chisel bejuda bijuda - widow bejudo bijudo - widower beker 
- cup bel - bell bela 
- crazy bela 
- candle sail bel di pia - thigh belaste - tax beleefd - polite belga - belgian  belgica biba den belgica - belgium bembe 
- purslane bena 
- vein benchi - to winnow fan bende 
- to sell bende 
- sold bendementu - sale bendicion - benediction bendiciona 
- to bless beneficio - benefits benta 
- to throwbenta 
- thrown benta abao - throw down benta afo - throw away bentana 
- window bentaha 
- advantage berdad 
-true truth berdaderamentu - truly berde 
- green 
- unripe berdura 
- vegetables greens beretrein - egg-plant berguenza 
- shame bertu 
- witch beshi 
- berry besindario - neighbor beskein 
- mould beslag - seizure bestia - beast bestial - beastly bestialmente - brutal bestualidad - brutality bet - bet beurt - turn ta bo beurt it is your turn biaha - trip voyage journey biaha - to travel to take a trip biahero 
- traveler biba 
- to live biba den - to live in  bibitu bisa bibitu 
- handy bibu 
- lively alert bichi 
- worm bicicleta 
- bicycle bicinidad 
- vicinity neighborhood bicinja 
- neighbor bicio 
- vice bad habits bida 
- life bida di cunucu - country life bienestar - well being welfare bientu 
- wind biernes santu - good friday bieu-bieu - very old bigoti 
- moustache bijechi 
- lottery ticket bina 
- deer binager 
- vinegar bini 
- to come bini bij 
- to regain consciousness binimentu - arrival binja 
- wine binti 
- twenty bira bleek - to turn pale bira 
- to turn become stir biraa 
- turned bira bieu - to get old become old bira bon - to get well bira corra - to blush bira jong - to get young to rejuvenate bira loco - to become bira miho - get better insane birada 
- curve turning biramentu di cabes - dizziness biramentu di stoma - nauseated sick stomach birgen - virgin birtud
- virtue birtuoso - virtuous bisa 
- to tell  bisanietu boda bisanietu - great-grand¬ child bisawela - great-grand¬ mother bisawelo - great-grand- ■pq fvlpv bise 
^ calf bishita 
- visit bishita 
- to visit bispu - vigil bispu di pascu - christmas eve bispu di anja-nobo - new year's eve bista - view site bisti - to dress to wear to put on bisti - to dress clothes blaar 
- blister blaas 
- bladder balloon blachi 
- leaf blafema 
- blaspheme curse blafemada 
- blasphemer blancha - 
white-wash blancu 
- white blaus 
- blue blauw - blue bleek 
- pale bleker 
- tin-smith bleki 
- tin can blenchi 
- humming-bird bio - alone - bio bashi entirely empty blokki - block bio sunu - stark naked blufein 
- car- blusa 
- blouse buncle bo - you your - di bo yours bobo 
- foolish stupid boca 
- mouth bay - boca prins boca - mouthful bochinchi 
- tumult boda 
- anniversary  boda di plata borchi boda di oro - golden anniversary boda di plata - silver anniversary bodega 
- cellar store boei - buoy boes - stomach craw buki boeki 
- book buki di misa 
- prayer book buki di lesa - reading book boet 
- fine 
boffi 
- milt spleen bofona 
- to make fun of bofta 
- slap bofta 
- to slap bohote 
- bundle bokkel - smoked herring bol - ball bolbe 
- to return bolbe tuma 
- to retake boletin - bulletin bolo - tart bolpees 
- whip boluntad voluntad 
- good-will bom - bottom bomb bombardero - bomber bon - good well kind bon beis - good humor mood bon bini - welcome bon dia - good-day good¬ morning bon nochi - good-evening good-night bon natura 
- good-natured bonechi - bonnet boonchi 
- beans boonchi jangado - old-wives boor 
- bit brace bora - to bore borchi 
- black¬ board  borda buta abao borda - to hem to embroider bordeshi 
- hut small house borduga 
^ hangman executioner borota 
- bristle clutter bos boz - thunder voice boshi 
- bunch bosman - boatswain boso - you 
boso-nan - plural of you bota - boot bota - to vote botanica 
- botony boto 
- boat boton 
- button botona 
- to button hotter - bottle box - to box boxdo
- boxer brabu 
- wild braza 
- arm braza - to embrace breid 
- bride brek 
- brake brek di man - hand-brake brek di pia - foot-brake bres brus - bridge breu - tar brik 
- brig broma - brag boast brongosa 
- ashame bula - to fly jump spring - bula pipa - to be a.w.o.l. busca - to look for to seek buscado di gera - trouble¬ maker buscuchi 
- biscuit buscuchi di pia - kneecap* bushi 
- diver buta 
- to place put busto 
- bust buta abao - put down  buta atencion cachi-candela buta atencion - pay attention butishi 
- jug • c caba 
- to finish to be ready caba 
- finished completed ready cabai cabay 
- horse cabai di awa - sea horse cabaitu 
- merry-go-round cabajero caballero - gentleman cabamentu - end cabana - straw cabaret - cabaret cabei cabey 
- hair cabei di wowo - eyelashes cabei peper - negro hair cabez cabes 
- head cabes indian - pope's head 
cabes sunu - bareheaded cabeza 
- to butt cabezanto 
- leader head of cabezura - self-will hard- headed cabisha 
- to nod cabitu - cigar or ciga¬ rette butt cabritu 
- goat cabu 
- handle cabuja 
- rope cacalaca 
‘ roach cacao 
- cocoa cachete - jaw chin cachi-cachi - coffee dregs cachi-candela - pistol revolver  cachimba calabas cachimba 
- tobacco 
cacho 
- dog cacho-machu - he-dog cacho-muhe - bitch cacho di barcu - cabin boy cacho tefe 
- bitch cachu 
- horn cachuela 
- thumb-tack cacu - a small lizzard cada 
- each cada bes bez ves 
- each time cada un - each one cada pasa un dia - every other day cadena 
- chain caduca 
- to forfeit worn out decrepit cadushi 
- cactus caha 
- box" case cahita 
- small box cai 
- to fall cai abao - fall down cai flauw 
- to faint cai-cai - gill 
caida - fall 
cai malu - fall ill get sick caiman - alligator caimas - jute caja caya - street cajena - cayenne pepper cajenta cayenta - to heat cajente 
- hot cajeru 
- rabble scum cajo 
- cal¬ lous cajon - cannon cakinja 
- candy calabas - gourd  calabas largu candal calabas largu - sweet gourd calcula 
- estimate calculate calculo - estimation calculation calidad 
- quality califica 
- to qualify calificacion - qualifi¬ cation calita - caliber caliz - chalice calma 
- calm calma 
- to quiet calm calmeki 
- buttermilk calor 
-warm warmth cama 
- bed cama di gai - cock's comb cama di morto - deathbed camarero - waiter cambia 
- change cambia 
- to change cambio 
- change 
camel - camel road way path camfer - camphor caminda 
- road path place camisa 
- shirt camna 
-to walk camnamentu - gait walk campo - camp cana - pint canal - canal canao 
- canoe canaster - fish-pot cancela 
- cancel cancer - cancer cancion 
- song candal 
- lock pad-lock  candela carabobo candela 
- fire cancionero - singe cane 
- cinnamon candidate - candidate cangrew - crab canibal - cannibal canica 
^ can 
canica di koffi - coffee¬ pot canja 
- sugarcane canja 
- in¬ toxicated tipsy cansa 
- tired weary fati¬ gued canto - to sing cantado 
- singer cantamentu - singing song cantica 
- song hymn cantidad 
- quantity cantina 
- bar-room cantine cantor - singer capa 
- to castrate capa 
- cas¬ trated capabel - capable capacidad 
- capacity capas - fit able capital - capital capitula - to capitu¬ late capoti 
- capote great coat capricho 
- caprice whim caprichoso - capricious freaky whimsical capsula 
- capsule captan 
- captain car a 
- face 
- dear expen¬ sive carabobo - candied gourdseed  caracter carton caracter - character caracteriza - charac¬ terize caramba - by jove the deuce my eye carbon - coal carbonisa - carbonize carbureter - carburettor cardinal - cardinal careda 
- row line carente 
- currant carentena 
- quarantine carga 
- to load caricari - gill 
caricatura - caricature caridad 
- charity car in j a - to caress carinjoso - winning cordial loving carnabal - carnival came 
- sheep carni 
- meat flesh carni di baca - beef carni di cabritu - goat- meat carni di came - mutton carni di diente - gumbs carni di porco - pork carpachi 
- dead skull carpata 
- castor-oil tick carpinte 
carpenter carpinteria - carpen- tershop caprusa 
- halter carson 
- pants trousers breeches carsonsijo - under-pants carson di abao - under¬ pants shorts carera 
- career carta 
- letter cartera - wallet hand¬ bag carton - carton  cartuche cen chikitu cartuche 
- shell cas 
- house ^ cas d.i aranja - spider s nest cas di paloma ^ pigeon house cas di gulinja - chicken coop cas di pastoor - pres¬ bytery casa - to marry casa 
- married wife husband casamentu - wedding casave - casava casca - skin of fruit shell of egg casca - peeled pared casca di webu - egg shell cascabel 
- rattlesnake cashipete 
- cashew nut cashu - cashew casi 
- nearly almost caso - case business castiga 
^ to punish chastise castigu 
punishment chastise¬ ment castol 
- high hat casualidad 
- casualty casualmente - casually catecismo - catechism categoria 
- category catibu 
- slave catibu di - slave to catolico - catholic catuna 
- cotton causa - cause reason causa - caused caweta - news carrier celebra 
- to celebrate celestial 
- celestial heavenly cement - cement cen cens - cent 
cen chikitu - half-cent  cende chuchu cende 
- to light censia 
- incense centro - center cerca 
- close by near cerbes cerbez 
- beer cercania 
- neigborhood ceru 
-mountain hill ceremonia - ceremony chambuca - to crumple to crush changa - to put one in a tight place chansa - joke chapaleta - propeller chapi - hoe spade charada - riddle che 
- bah! chemene - stack chim¬ ney chens - chance chepi-chepi 
- sticky gluey chica - to scoop to bale out chicaron - lard chike - hog food chike di porco - hog-sty chikitu 
■ small little china - china chincha - catapult chino - bald chino-chino - very bald entirely bare chip - awa di chip - to drizzle drip chip - to chip chispa 
- spark chiste - mop joke choca - to choke to strangle chocolate - chocolate chok - to stick fast stalemated chokful - choke full crowded chokle - partridge chonchorogai - sparrow chubatu 
he goat ram chuchu - rye  chuchubi coco chuchubi - thrush chumbo 
- lead chupa 
- to suck chupabebe 
- lollypop chupador di sanger - vampire chupon 
- teat nipple ciegu - blind cielu cielo - heaven cielu di boca - roof of mouth palate ciencia - science cierto - certain cifra - number ciga 
- cigar cigaria 
- cigarette cinco - five cincuenta - fifty circo - circus circula - circulate circulacion - circulation circumstancia - circum¬ stance cita 
- to cite civilisa - to civilize civilisacion - civiliza¬ tion cla kla - finished ready claba 
- to nail claba 
- nailed clabu 
- nail 
clara - to clear up clasifica - to classify clasificacion - classifica¬ tion cleconchi - acorn-shell clero 
- clergy club 
- club coba 
- to dig coba 
- dug cobarda - to frighten cobarde 
- coward cobardia 
- cowardice cobra - to charge to collect 
cobra 
- col¬ lected charged cobramentu - collecting charge cocada - cocoanut cake coco - cocoanut  cocobia combenio cocobia 
- to stagger cococha 
- to stumble cocolishi - shell 
cocoroshi 
- ankle cocoti 
- elbow coffi - coffee coha 
- to limp cohe 
- to catch to pluck cohe ariba - to catch in the act cohe di sopresa 
- to take by surprise cohe sonjo - to fall asleep coho cojo 
- cripple 
coi dushi - candy sweets coi glas - glass-ware coi di hari - something laughable coi kibra - breakable fragile coi loco - foolishness coi macacu - nonsense coi mucha - childishness coi sucu - sugar bowl coi shushi - dirty things coitu 
- cripple 
cojar - necklace col 
- collar colebra 
- snake collecion - collection colleccionista - collec¬ tor collecta - collected collecte - collection to collect colo " cabbage colocolo - dregs colga - to hang suspend color - color colora - to color com 
- how comader - god-mother combence 
to convince combeni 
- to agree combenio 
- agreement  pnmfaenio di trabao completacion combenio di trabao - work agreement combento 
- comment combersa 
- to converse combersacion - conver¬ sation comberti 
- to convert combida 
- to invite combina 
- to combine combinacion - combina¬ tion come 
- to eat come golos - to eat greedily comedor - dining-room comehein - termites comenta - to comment comentario - commentary comerciante 
- merchant comercio 
- commerce comete 
- to commit comflochi - bosom-friend comite - committee comite nominative - nominating committee comisario - commissary commies - departmental clerk compa compador - com¬ panion friend compania 
- company companja 
- to accompany companjero - companion companjo - company compara - to compare comparacion - comparison compasion - compassion compensacion - compensa¬ tion competente 
- competent compiti - compete compinchi - bosom-friend complase 
- to please complete - complete complete - to complete completacion - comple¬ tion  cdmpletamente confe completamente - com¬ pletely complica - complicated complicacion - compli¬ cation complimenta - to com¬ pliment complot - plot conspi¬ racy compone 
- to compose comporta 
- to behave comportacion - conduct behavior compra cumpra - buy purchase compras - purchase 
composicion - composi¬ tion comprende 
- to understand comprendibel 
- under¬ standable comprini 
- to compromise comun 
- common comunica 
- to communicate comunicacion - communi- cation  comunidad - community comunion - communion i comunista - communist concentra 
- to concen¬ trate i concerna - concerned concentracion - concen- i tration | concurso - contest  condena 
- to condemn  condensa 
- to condense  condesa 
- countess condicion 
- condition conditional 
- condi¬ tional ^ conenchi 
- rabbit coneo 
- i rabbit m confe - as soon as fl coal pail m  conference considerabel conferencia 
« con¬ ference confesa 
- to confess confia 
- to confide confiansa 
- confidence confirma 
- to confirm confirmacion - confir¬ mation confisca 
- to confiscate conforma - to comfort console conform confusion - confusion congestion - congestion conjunto - joint reunion conjunto - joint meeting commemora - commemorate conoce 
- to know to be acquainted with conocementu - acquain¬ tance conoflo - cauliflower conopi 
- to button to know conopi 
- fist knuckle thump conoshi - sweet ducky conovis - kingfish consecra - consecrate consecracion - conse¬ cration consecuencia - consequence consecuentemente - conse¬ quently conseha 
- to advise counsel consehabel - advisable conseho 
- advise consenshi - conscience consenti - to consent consecuentemente - con¬ sequently conserba 
- to preserve consequi - to consign considera 
- to consider consideracion - consi¬ deration considerabel - conside¬ rable  consola contra tiemt)q consola 
- to console conspira - to conspire conspiracion - conspi¬ racy plot constancia - constant constante - constantly constipa 
- constipated constipacion - con¬ stipation constituyente - con¬ stituent construi 
- construct construcion - construc¬ tion consuelo - comfort con¬ solation consulta 
- to consult consultacion - consul¬ tation consulto - consult conta 
- to count to add to tell conta 
- counted added contene 
- to contain contenedo 
- contents contenta 
- to please to content contentu 
- pleased glad contesta 
- to answer contesto 
- ansv/er continua - to continue continuacion - continua¬ tion continuamente - conti¬ nually contra - against contra gustu - unwip ling contra banda - farm hand contrabandista - smug¬ gler contract - contract contracista 
- contrac¬ tor contrari 
- opposite con¬ trary contra tiempu - disap¬ pointment  nontribucion corta contribucion - contri¬ bution contributario - contri¬ butor contrui 
- to contribute controla 
- to control convense 
- to convince conveniencia - conve¬ nience coper 
- copper copia 
- to copy copio 
- copy copra 
- corpo¬ ral corant courant - news¬ paper corcoba 
- crooked corda - think remember corda bon - remember well cordamentu - remembrance cordon - band corihi corigi - to cor¬ rect corki 
- cork cornetin - cornet corocoro - adam’s apple corona 
- crown corona 
- to crown corona obra - to crown the work coronacion - coronation corra - red corre - to run corre cabai - to ride a horse corre cohe - to play tag corre cu - to chase away disperse corre paranda - spree corredor - hall-way corresponde - to corres¬ pond correspondencia - corres¬ pondence corriente - current corrompi - to corrupt to spoil corsow - curacao corta 
- to cut corta 
- cut  corta awa crude corta awa - to cleave the waves corta lechi - to curdle corta orea - to take away one’s sweetheart or wife corta palabra - to in¬ terrupt corticu 
- short brief cortina - curtain # cos 
- thing cose 
- to sew cosechi - harvest cosedo 
- seamstress costa - cost coast costia - side 
costoso - expensive cramchi 
- faucet tap crans - wreath cran-craw - grizzle crece 
- to grow crecementu - growth creencia - knowledge thought belief cremencha - to economize cria 
- to raise to grow create cria 
- maid servant criacion - creation criador - creator crianza - education bringing up training criatura - creature criki - cricket crimen - crime criminal - criminal creo - hatched crisis 
- crisis cristian - christian cristianismo - chris¬ tianity cristu 
- christ critica - to criticize critico - critic cronchi - bread-crust crucifica - to crucify crucificacion - cruci¬ fixion crucificado - crucifix cruel 
- cruel crueldad - cruelty crudo - crude  crus cuerda crus cruz - cross crusa - to cross cu qu 
- with who than cu atencion - with at¬ tention cu berguensa - with shame cu cuidao - with care cu esei - with that cu excepcion di - with the exception of cu gustu - with pleasure cu kiko - with what cu sanger friu - in cold blood cu ta pega - contagious cu tur esei - with all that cu un palabra - in one word cuadra 
- square cuaha - to congeal cualke - whichever cualke hende - some one somebody cuantu cuanto - hov/ much cuarenta 
- forty cuaresma 
- lent cuartisa - to quarter cuarto 
- room quarter cuater 
- four cubri 
- to cover cuchara 
- spoon trowel cuchara chikitu - tea¬ spoon cuchara grand! - soup spoon cuchu 
- knife cudisha 
- to begrudge to envy cudishi - grudge dislike cusihioso - envious cuebo 
- cave cuenta 
- story tale narrative cuenta - business foi bo cuenta - not your business ta mi cuenta - it is my business cuerda - string 
spring 
cuerde curioso cuerde - to wind cuerpo di delito - cor¬ pus delecti cuero 
- skin leather cue 
- cage cuida 
- to take care of cuidao 
- care be careful take care look out # cuidao cu - be careful with culebra 
- snake culpa 
- fault culpabel - faulty cultiva 
- to cultivate cuminda 
- food meal victuals cuminda 
- to greet cumindamentu - greetings cuminsa 
- to begin cuminsamentu - beginning cumpli cu - to grant cumpli anja - birthday cumpli cu su deber - to do one's duty cumpra 
- to buy to purchase cumpra 
- bought purchased cumprador - buyer pur¬ chaser cunja 
- sister- in-law consumi - to offend to annoy cunukero 
- farmer cunuku cunucu - farm country cupi 
- in¬ step cura 
- to cure to heal cura 
- yard curamentu - healing curasha 
- to encourage curashi 
- courage curazon 
- heart curazon di pia - arch of the foot curiosidad - curiosity curioso - curious  curpa debolbe curpa 
- body curti - to tan 
curu 
- raw cushi 
- done 
cushina 
- kitchen cus nclii 
pillow custia costia - side 
custuma 
- to accustom custumber - habit custom cutis - epidermis d dadel 
- date 
dacoco 
- chaff dagvaar - to cite sum¬ mons dak - roof dal 
- to strike hit dal mata 
- to kill dal un gritu 
- to give a yell a cry a scream dal skop - to kick dal wanta - to slap dal bai - hit and run run away dam - dam draughts damast - damask dams - young lady danja 
- to spoil dan jo 
- damage danki 
- thanks danza 
- dance dao 
- dice dashi 
- tie dashi pushi - bow-tie dauw 
- dew debe 
- to owe deber 
- duty de bez en cuando - once in a while debocion - devotion debolbe - return debolbi - returned debota delegacion debota 
- to devote december 
december decencia - decency decente 
- decent decidi dicidi - to decide decidido - resolute firm decimo - twentieth part decision 
- decision decisivo 
- decisive declara 
- to declare declaracion - declaration decora - to decorate decoracion - decoration decreta 
- to decree decreto 
^ decree 
dede 
- finger dede chikitu - little finger dede di pia 
- toe dede grandi di pia - big toe dedica 
- to dedicate deduccion - deduction defecto 
- defect defende 
- to defend defensa - defense defensive - defen¬ sive defunto difunto - deceased dead definicion - definition degenera 
- degenerate degrada - to degrade de heel 
- jaundice dek - deck dek di carta - a deck of cards dekel 
- blanket delanta 
- to get up to arise delega 
- thin skinny meager delega 
-to delegate delegacion 
- delegation  r delirio delirio 
- delirium delibera - to consultto deliberate upon deliberacion - consul¬ tation deliberation delicado 
- delicate demanda 
- to demand demasiado 
- too much democracia 
- demo¬ cracy democrat 
- democrat demonjo - devil demonta - to take apart demostra - to demonstrate demostracion - demonstra¬ tion dempel - extinguish quench fill up 
den - in the den diente - in an under tone den nanishi - nasal in the nose desagradicido denter di - in between dentista 
- dentist den un guli 
- in one swallow depchi - ten cent dutch coin depende 
- to depend on dependencia - dependence dependiente - dependent depone - lay down resign one’s office deporta - to deport deposita - to deposit deposito - deposit dera 
- to bury dera 
- buried deramentu 
- funeral derechi 
- right derecho 
- right claim derota 
- defeat conquer desagradabel - disagree¬ able desagradicido - ungrate¬ ful  desajuna desformal desajuna 
- to take break¬ fast desajuno - breakfast desamina 
- to discourage desarma - to disarm desarmamentu - disar¬ mament desaroya - develop unfold desaroyo - build up desastre - disaster descansa 
- to rest descarga - to dischar¬ ge 
unload descendiente - descen¬ dant desconfianza 
- mistrust distrust desconoce 
- to disclaim knowledge desconfia (dace-kohn- fee-ahf - to mis¬ trust distrust desconseha 
- to dissuade describi - describe descripcion di trabao - work description descubri 
- to discover descubrimentu - dis¬ covery descuento - discount descuida 
- to neglect descuido - neglect carelessness descustama - to be un¬ accustomed desde 
- since desea 
- to desire wish long for deseable - desireable desembarca - to dis¬ embark deseo - wish desire 
deserta - to desert desespera - to despair desesperacion - 
despair desfigura 
- to dis¬ figure maim desgracia - accident desformal - informal  f^esgraciado di ripente desgraciado - misera- ble wretched desinfecta ^ to dis¬ infect despacha 
- to dispatch despedi 
- to separate to dismiss discharge despedida - farewell desprecia - to scorn despise to hold in contempt despreciabel - scornful despicable desprecio - contempt scorn despues 
- later after destila - to distill destina 
- destined destinacion - desti¬ nation destino 
- destiny destruccion - destruc¬ tion destrui 
- to destroy desunion - discord dis¬ sension detaja - detail determina - to determine di 
- of from over di 
- to say ki bo di? - what do you say? di acuerdo - unanimous di aleu - from afar di bende - for sale di berde - truly di berde mes - real true di chiripa 
- casually di dia 
- by day di golpi 
- suddenly di manera cu 
- so that di mas - too much 
di mas menos - the least di modo cu 
- so that di nobo - anew di remata 
- hopeless di ripiente - suddenly  di sobra dignidad di sobra 
- left over abundant dia 
- day bon dia - good day good morning diabel 
- devil diabernes 
- friday diablura 
- devilish trick diadomingo 
- sunday diahuebes 
- thursday dialuna 
- monday diamars 
- tuesday diarazon 
- wednesday diameter - diameter diario - diary daily news paper diasabra 
- saturday diberti 
- to divert relax dibinidad - divinity dibino 
- divine dibuho 
- sketch drawing diccionario - dictio¬ nary dici 
- to say dicidi decidi - to de¬ cide discurso - discourse speech dieet 
- diet diente 
- tooth diez
- ten diez-un 
- eleven diez-dos - twelve diez-tres - thirteen diez-cuater - fourteen diez-cinco - fifteen diez-seis - sixteen diez-siete - seventeen diez-ocho - eighteen diez-nuebe - nineteen diferencia - difference diferente - different dificil 
- difficult dificultad - difficulty dignidad - dignity  digno distancia digno - worthy diki 
- thick dilanti 
in front of dios 
- god diploma - diploma cer¬ tificate direccion - direction address direct 
direct directamente - directly directiva 
- management director - director mana¬ ger dirigent - conductor leader of a band dirigi - to lead govern rule manage drive dirti 
- to melt disapunta - disappointed disco 
- disc record dicision - decision disciplina - to discip¬ line discipulo - scholar pupil discrecion - discretion discurso - speech talk lecture discusion - discussion discute - to discuss to talk over discutibel - discussable disfraz - masked disfraza - to mask dis¬ guise disgusta - to disgust disgustu - disgust 
disolve 
- dissolve disparati 
- folly foolish¬ ness disparce - to disappear dispensa - to grant dis¬ pensation to excuse dispensable - dispensable dispidi - to waste squander dispididor - spendthrift dispone - to dispose of disposibel - disposable disputa - to argue dis¬ pute dispute - dispute quarrel distancia - distance  dissatifaccion duna dissatisfaccion - dissatis¬ faction distingui - to distinguish distino - separate other¬ wise distrai - to distract amuse distraicion - distraction distribi - to spend waste distribucion - distribution districto distrito - dis¬ trict divan - divan division - division djaca 
- rat djimbi - convulsion fits of infants djipopo - mushroom djis 
- pre¬ sently at once djombi 
- boy’s blouse djonki 
- a large piece of some thing dobbel - double dobbelsinti - ambiguous dobla 
- to bend double fold dobla 
- bent folded dobla cabes - to bow to bend the head doctrina 
- doctrine dokter - doctor dol - yolk of an egg tholepin oarlock dolo dolor - pain domine 
- to dominate domingo di rama - palm - sunday domingo di resureccion - easter sunday domino - domino dommi - protestant clergyman minister don - talent donder - thunder donderbus - thunderbolt donjo - owner possessor proprietor dora - to gild duna 
- to give duna man - to shake hands duna nobo - to give the news duna op - to give up  (^iina order ehecuta duna order - to give or¬ ders duna sorpresa 
- to give a surprise dunamentu - giving duplicaat - duplicate duru 
- to last durabel - durable duranti 
- during dureza 
- hardness brittleness duru 
- hard duru'duru - very hard dushi 
- sweet sweetheart e e 
- he she it e 
- the ebolter - to turn over capsize ebonit - ebony 
echo 
- deed fact eco 
- echo economia 
- economy economico 
- economi¬ cal thrifty economisa 
- to econo¬ mize eczema 
- eczema edad 
- age edicion 
- edition edita 
- to publish edit editor 
- editor educa 
- to educate educacion 
- education efecto 
- to affect egoismo 
- egoism sel¬ fishness egoista 
- selfish egoistic ehecuta 
- to execute  ehecucion emision ehecucion 
- execution ehecutivo - executive ehempel 
- example por ehempel - for example ehercicio 
- exer¬ cise ehercito 
- army ei aja - there eibanda ajabanda - that way that side over there eibao ajabao - under there eiden ajaden - in there eitras ajatras - behind there ekiboca 
- to be mistaken ekibocacion - misun¬ derstanding el 
- he she it elastik - rubber elastic eleccion 
- election electa 
- to elect elector - elector electricidad 
- elec¬ tricity elementario - elementary eligi 
- to elect eligibel - eligible elimina 
- to eliminate elocuente - eloquent emancipa - emancipate embahada 
- embassy embahador - ambassador embarca 
- to embark embarcacion - embarka¬ tion emblema 
- emblem emigra 
- to immigrate emigracion 
- immigration eminente - eminent emision - emission  emiti erege emiti - to edit dis¬ tribute emocion 
- emotion emocional - emotional emperador 
- emperor emperatris 
- empress empleado 
- employee empleo 
- employ enamora 
- to be in love with enano 
- dwarf encanta - enchanted bewitched encarga - to charge with encargo - order encerra - enclose encia 
- gumbs encuadra - to put in a frame encuentro - to meet enemigo - enemy energia 
- energy enfermedad - illness sickness disease enfrenta - confront ensja - to review repeat ensajo - repetition ensajo general - ge¬ neral review enter 
-to vaccinate entra - to enter come in entrada - entrance income entrainamiento - training entre - between among entrega 
- to deliver 
entrego - order delivery 
entremente - to interfere with meddle with entusiasmo - enthusiastic envelop - envelope envidia - to envy e ora - then epa 
- hey! epidemia - epidemic erege 
- heretic  eregia evento eregia - heresy erf - to inherit esaja - that over there esaki saki - this escala 
- scale esclavitud - slavery es - the esei - that esencia 
- essence esencial - essential esfera - scope esfuerzo 
- effort esmeralda - emerald eso es 
- that is it so it is establece 
- to establish establecimiento - estab¬ lishment estado 
- condicion state na estado - pregnant estatua - statue estibo 
- trend way manner estima 
- to estimate esteem estimacion 
- estimation budget estremo 
- debut estropilla - cambric estudio - study 
esun 
- that one the one eternidad 
- eternity eterno 
- eternal europa 
- europe europeo 
- european evacua 
- evacuate evacuacion 
- eva¬ cuation evadi 
- to evade evangelio 
- gospel evangelista - evangelist evapora 
- to evaporate evento - event  evita expresion evita 
- to evade exacto 
- exactly exalta 
- to exalt examina 
- to examine excepcion 
- exception excepcional 
- exceptional excepto 
- except excitacion 
- excitement excurcion 
- excursion exaheracion - exagge¬ ration exhera 
- to exaggerate exhibicion - exhibition exibi 
- to exhibit existencia - existence existi 
- to exist exita 
- to excite exitabel 
- excitable irritable exito 
- success experiencia 
- experience experimenta 
- to experi¬ ment experimento - experiment explora 
- to explore explosion 
- explosion explosivo 
- explosive explota 
- to exploit expone 
- to expose display ex¬ hibit exporta 
- to export exportacion - exportation exposicion - exhibit exposition expresa 
- to express expresion - expression  exterior famoso exterior 
- exterior extingi 
- to extinguish put out extrabogante - extrava¬ gant extracta 
- to extract extraordinario - extra¬ ordinary extremo 
- extreme f fabor 
- favor faborabel 
- favorable faborece 
- to favor fabrica 
- factory fabrica 
- to fabricate fabricacion 
- fabrica¬ tion facil 
- easy facilidad 
- facility facilita 
- to facilitate facilmente - easily fada 
- to annoy disgust fada 
- an¬ noyed disgusted fed up with faha 
- belt faillet 
- bankrupt faja (fah-yah - to fail falsifica 
- to forge falsify falsificacion - falsi¬ fication counterfeit falsu 
- false treacherous falta 
- to miss mistake lack falta poco - nearly almost to lack a little fama 
- fame famija famia - family famijar 
- familiar faihoso 
- excellent famous  fanatico fiera fanatico 
- fanatic fantasia 
- fantasy fantastica 
- fantastic faro 
- light¬ house fastia 
- to annoy fastioso 
- annoying fastidious trouble¬ some fatal 
- fatal favorite 
- favorite fe 
- faith februari 
- february fecha 
- date feila 
- to scrub mop feilu 
- swab mop feita 
- to shave felicita 
- to congratulate felicitacion - congra¬ tulations felpa 
- vel¬ vet feliz - happy feliz pascu - happy christmas femenisna - feminine feneta 
- pin feria 
- fair fermenta - to ferment feros 
- wild furious fertil 
- fer¬ tile fia 
- to borrow to lend to loan fia 
- to borrow borrowed 
fiamentu - loaning bor¬ rowing ficha - badge ficho 
- coun¬ ter check fiel 
- faith¬ ful fiera 
- wild  fierno flor fierno 
- hell fiesta 
- party celebration figo 
- fig figura 
- shape form figure figura 
- to imagine fiha 
- mended repaired patched fiha 
- to-ad- just mend repair fila 
- to file sharpen film - film filosofia - philosophy filosoof - philosopher filtra 
- to filter fin 
- end porfin - at last financia -■ finance fin-fin 
- to drizzle fingi 
- de¬ vise invent contrive fini 
- fine thin firma - to sign firmo - signature firma - signed firmamentu - firmament firme 
- firm fisco 
- treasury chest fis¬ cal fishi 
- trade fisica - physics flacu 
- thin skinny meager flakesa 
- thinness leanness flambeu - torch flambojan - flamboyant flamingo - flamingo flanco - flank flankea - to flank bottle fleit fluit - to whistle fleishi - vial small whistle 
flenster - to dash dump flerchi 
- arrow fli 
- kite flit 
- flit flohera 
- laziness floho 
- lazy flor 
- flower  flora frambuesa flora 
- to bloom to blossom florero 
- vase floria 
- to bloom florin 
- florin guilder flus fluz 
- suit foco 
- focus fofo 
- hollow fogon 
- water- can foi otro - apart foja 
- foliage fojo 
- leaf 
fondo 
- bot¬ tom fund 
fono 
- other¬ wise fontein - fountain for di - out of for di awor - from now on henceforth for di man - second hand forki 
- fork forma 
- to form formacion 
- formation formal - formal formalidad - formality formula - formula fornu 
- oven furnace forsa forza 
- strength tin forsa - to be strong forsa 
- to force forti - fort fortifica 
- to fortify fortificacion - fortifi¬ cation fortuna 
- fortune fortuna 
- fortunate foto 
- photo fotograaf - photographer fracasa 
- to fail fracasco 
- failure farce fractura 
- fracture frambuesa - raspberry  frances frances - frenchman francia - france franco 
- frank franja 
- to raffle frankea - to tax 
frankeza - frankness frater - christian lay- brother frecuencia 
- frequency frega 
- to scour to annoy frega 
- troublesome frega di wowo - to wink frena 
- bridle frente 
- fore¬ head fresca 
- to cool frescu 
- cool fresh fret - wart fri-fri 
- to flatter cajole fria 
- to freeze friedad 
- coldness fura. frik - to scull friu 
- cold fruminga - ant frus 
- rust frusa - to rust frusa 
- rusted fruta 
- fruit fruta di pan - bread¬ fruit fucu 
- witch fuente 
- source fuera - cover fuera di - except bar¬ ring fuerete 
- dol¬ lar strong fula 
- to feel fulan di tal - mr. so- and-so fuma 
- drunk intoxicated funcion - function funda 
- to ground funda 
- grounded fundeshi 
- foundation fura 
- to line install a lining  furia garashi furia 
- fury furioso 
- furious furiosomente - furiously furturo - future fusila 
- to shoot g gaba 
- to boast brag gabamentu - boasting gabardin - gabardine gagu 
- stut¬ ter gai 
- cock 
gun galante 
- gallant galeria 
- gallery galinja 
- hen sweetheart galon 
- gal¬ lon galop 
- gal¬ lop galopia 
- to gallop galvaniza 
- galvanized gambo yambo - ochre gana 
- desire wish longing like to ganamentu - earnings ganashi 
- profit gancha 
- to hook gancho (gahn-choh - hairpin gangrena 
- gangrene ganja 
- to lie to fool ganja 
- untrue ganjador 
- liar ganjamentu - lie 
un¬ truth garafi 
- waterbottle decanter garantia 
- guarantee 
garantisa 
- to warrant guarantee garashi 
- garage  garganta 
- throat garna 
- to grind crush garna 
' ground crushed garnachi 
- shrimp garoshi 
- cart wagon garoshi di sushi -rub¬ bish truck garoti 
- walking stick gas (gahs; - gas gasolin 
- gasoline gasta 
- to use spend waste gastador - spendthrift gastu 
- expenses gatia 
- to creep gelatina 
' gelatine genera 
- generate generacion - generation general 
- general generalisa - to genera¬ lize generosidad - genero¬ sity generoso 
- generous gengu 
- green sea-crab geografia - geography geometeria - geometry gera guera - war gerente 
- manager gesticula - gesticulate gija 
- to steer to drive lead gitara 
- guitar glas - glass globo 
- globe lamp shade gloria - glory glorifica - glorify glorioso - glorious goberna 
- to govern gobernador 
- governor gobierno - government gogora grapa gogora 
- to bore with an awl golet - two-masted schoo¬ ner golos 
- greedy gluttonous goloso 
- greedy gluttonous golpi 
- a blow 
di golpi - suddenly gorda 
- to fatten put on weight gordo 
- fat gordura 
- fat grease weight gosa goza 
- to enjoy gosamentu - enjoyment gota 
- drop go tea 
- to drop graba 
- to en¬ grave grabador 
- engraver grabe grave - criti¬ cal risky grave gracioso 
- gracious gradici 
- to thank gradicido 
- grateful thank¬ ful gradicimentu - gratitude grado 
- grade gradua 
- to graduate gradual 
- gradual graf - grave tomb gram - gram gramatica 
- grammar gramatical - grammatical gran - large great granat apel - plum gra¬ nite grandeza 
- greatness grandi 
- large big grandiose 
- grand majestic grandura 
- size granit - granite grapa 
- grasp seize catch  garganta gobierno garganta 
- throat garna 
- to grind crush garna 
- ground crushed garnachi 
- shrimp garoshi 
- cart wagon garoshi di sushi -rub¬ bish truck garoti 
- walking stick gas 
- gas gasolin 
- gasoline gasta 
- to use spend waste gastador - spendthrift gastu 
- expenses gatia 
- to creep gelatina 
- gelatine genera 
- generate generacion - generation general 
- general generalisa - to genera¬ lize generosidad - genero¬ sity generoso {hay-nay-roh- soh) - generous gengu 
- green sea-crab geografia - geography geometeria - geometry gera guera - war gerente 
- manager gesticula - gesticulate gija 
- to steer to drive lead gitara 
- guitar glas - glass globo 
- globe lamp shade gloria - glory glorifica - glorify glorioso - glorious goberna 
- to govern gobernador 
- governor gobierno - government  gogora grapa gogora 
- to bore with an awl golet - two-masted schoo¬ ner golos 
- greedy gluttonous goloso 
- greedy gluttonous golpi 
- a blow 
di golpi - suddenly gorda 
- to fatten put on weight gordo 
- fat gordura 
- fat grease weight gosa goza 
- to enjoy gosamentu - enjoyment gota 
- drop gotea 
- to drop graba 
- to en¬ grave grabador 
- engraver grabe grave - criti¬ cal risky grave gracioso 
- gracious gradici 
- to thank gradicido 
- grateful thank¬ ful gradicimentu - gratitude grado 
- grade gradua 
- to graduate gradual 
- gradual graf - grave tomb gram - gram gramatica 
- grammar gramatical - grammatical gran - large great granat apel - plum gra¬ nite grandeza 
- greatness grandi 
- large big grandiose 
- grand majestic grandura 
- size granit - granite grapa 
- grasp seize catch  gratis habrimentu di barica gratis 
- gratis free of charge gratitud - gratitude grawata 
- to itch scratch grawatamentu - scratching itching grecoa - greece grender - bolt griego - greek grif - slate-pencil gris 
- grease fat grita 
- to bawl to scream yell gritu 
- scream yell 
grof 
- rough coarse groin - ground 
gros 
- gross groseria - impolite¬ ness impertinence grua - crane grunja - to groan sigh grupo - group gujaba - guava guli 
- to swallow guma 
- starch mucilage guma 
- to starch gusta 
- to like gustoso 
- attractive gustu 
- desire longing liking h haaf - harbor haak - hook haap - to yawn habita - to inhabit habitante 
- inhabitant habon 
- soap habon dushi 
- sweet soap habona 
- to soap to lather habri 
- to open habrimentu di barica - diarrhea  habusa hala un banda habusa 
- to misuse habuso 
- abuse misuse 
hacha 
- hat¬ chet haci 
- to do haci 
- done haci anja - birthday haci brua - to witch haci cuminda - to prepare food haci danjo - to damage haci donjo - to take possession of hacidor di gera 
- warmonger haci due 
- to pain hurt haci falta - to miss haci huma - to make smoke haci lihe 
- be quick haci mas grandi - to en¬ large hacimentu di anja - birth¬ day haci mofa 
- to make fun of haci penetencia 
- to do penance haci pica 
- to sin haci propaganda - to campaign haci su best - to do one’s best haci tristu 
- to sadden make sad to grieve hagel - hail hagel di skopet - shot haja hanja - to find to get hal - gall hala 
- to haul pull rub massage hala ariba - pull up hala atras - pull back hala lechi - to milk hala pagai - to paddle hala rosea 
- to breathe - hala rosea duro to take a deep breath hala un banda - to pull aside  haltu heers haltu 
- high tall haltura 
- height halza 
- to lift to raise to hoist ham 
- ham hamaca 
- hammock hamber 
- hunger tin hamber - hungry hancha 
- to widen broaden hancha 
- widened hanchi 
- al¬ ley hanchu 
- wide broad hanora 
- to anchor hanja 
- to get hanja bon - to agree to to approve of hanja malu 
- to disapprove of hanja miedu - to be frightened hanja sa - to get to know hantu - time off 
hapa 
- leg of mutton hapon - japan hapones - japanese haraga - to loaf idle haranga - spider hardin 
- garden hari 
- to laugh harimentu - laugh 
harma - arms weapons harma 
- armed harmonia - harmony harnas - harness harpa - harp harpon - harpoon hasa 
- roasted hasechi 
- dish hecha 
- ripen hecho 
- deed action fact hechu 
- ripe hechu-hechu - over-ripe heel 
- yellow heers 
- hoarse  heet historia heet 
- gutter spout hefe 
- boss supervisor hekchi 
- rail hember - ginger hende 
- person henio 
- cha¬ racter hente 
- entire whole henteramente 
- entirely her a 
- to err to miss herebe 
- to boil heredero 
- heir herencia - inheritance }ipr*l-‘a prp herida 
- wound herment - tool heru 
- iron heru di strika - flat iron hespu - buckle hesucristu 
- jesus christ hesus 
- jesus heut - gutter hiba 
- to bring to take to to carry hiba mal bida 
- to live a bad life hiba rond - take around hielchi 
- heel hier 
- to rent hire higra 
- liver hik 
- hiccough hilu 
- thread himno 
- hymn hinca 
- to stick to prick to put in hinca rudija - to kneel hincha 
- to swell hincha 
- swol¬ len hipoteca - mortgage hisa 
- to lift raise hoist hisa bandera 
- to hoist the flag historia 
- history story  hoben hundi hoben 
- young youth hoffi 
- orchard hoga 
- to drown hoga 
- drowned holandes - dutchman holandia - holland hole 
- to smell hole stinki 
- to smell holo olo - smell scent homber - man hombresa - manly honing - honey honor - honor honra - to honor honrado - honorable spout hoos 
- water- hopi 
- much many plenty hopi biaha - many times often horca 
- to hang horgel - to gargle horizont - horizon horketa - pitch-fork horribel - horrible horroso - awful horta 
- to steal hortamentu - theft hospital 
- hospital hospitalidad - hospita¬ lity hotel - hotel hubentud - youth hubila - to jubilate hubilario - celebrant hubileo - jubilee hudio - jew huebes santu - holy thursday hues 
- judge hugo 
- juice hui 
- to flee run away huma 
- smoke 
smoke 
humanidad - humanity humano 
- human humilde 
- humble humilidad 
- humility hundi 
- to smell 
hundu iguala hundu 
- deep hunga 
- to play 
hunga carta - to play cards hunga dam - to play checkers hunga dao - to play dice hunga domino - to play do¬ minoes hungador - player hunga futbol - to play soccer hunga malbu - to play mar¬ bles hunga skaak - to play chess hunga tennis - to play tennis hunga wega di ladron - to cheat hunja unja - nail 
hunta - to join together hunto 
- together hura 
- to swear husta 
- to adjust hustamente - honestly husticia 
- justice hustifica 
- to justify husto 
- just fair honest huzga 
- to condemn to judge i i 
- and beside including idea 
- idea ideal 
- ideal idioma 
- idiom language ignorancia 
- ignorance ignorante 
- ignorant igual 
- equal iguala 
- to equalize  igualmente indeseabel igualmente 
- equally iha 
- godchild ilumina 
- to illuminate imagina 
- to imagine imahen 
- image imahinacion 
- imagination imediata 
- immediate imita 
- to imitate imitacion 
- imitation importa 
to import importacion 
- importation importante 
- important imposibel 
- impossible imposibilidad - impossi¬ bility impresion 
- impression impresiona 
- to impress incarnacion 
- incarnation inclina 
- incline inclinacion 
- inclination inclusion 
- inclusion incompetente 
- incompetent incomplete 
- incomplete incomprendibel - incompre¬ hensible inculpabel 
- innocent faultless incurabel 
- incurable indecente 
- indecent independencia - indepen¬ dence independiente 
- in¬ dependant indeseabel 
- undesirable  india inhala india 
- india indian 
- indian indica 
- to indicate indicacion 
- indication indigestion 
- indigestion indispensabel 
- indis pensable individual 
- individually individuo 
- individual industria 
- industry inespera 
- unexpected inevitabel - inevitable infeccion 
- infection infecta 
-to infect inferior 
- inferior infiel 
- un¬ faithful inf lama 
- inflame inflamacion 
- inflamation influencia 
- influence informa 
- to inform informacion 
- information informativo 
- informative ingenioso 
- ingenious inglatera 
- england ingles 
- englishman ingratitud 
- ungrate¬ fulness ingrato 
- ungrateful ingrediente 
- ingre¬ dient inhala 
- to inhale  inhusticia instante inhusticia 
- injus¬ tice inhustu 
- unjust ink 
- ink inkpot 
- ink¬ well inmenso 
- inmense inmigra 
- to emigrate inmigracion 
- emigration inmoral 
- immoral inmoralidad 
- immorality inmortal 
- immortal inmortalidad 
- immortality inocencia 
- innocence inocente 
- innocent inscripcion 
- inscription insecto 
- insect inseparabel 
- inseparable inserta 
- to insert insinua 
- to insinuate insinuacion 
- insinuation insisti 
-  to insist insoportabel 
- in¬ supportable inspeccion 
- inspection inspecta 
- to inspect inspector 
- inspector inspira 
- to inspire inspiracion 
- inspira¬ tion instala 
- to install instancia 
- instance instante 
- instant  instiga^ inundacion irwtiga 
- to instigate instigador 
- instigator instinto 
- instinct institucion 
- institu¬ tion institue 
- to institute institute 
- institution instruccion 
- instruction instructor 
- instructor instrumento 
- instrument insulta 
- to insult insulto 
- insult intacto 
- intact inteligencia 
- intel¬ ligence inteligente 
- intelligent intencion 
- intention interes 
- interest interesa 
- to be interested interesante 
- interested interior 
- interior interna 
- intern interpretador - inter¬ preter intervencion 
- intervention interveni 
- intervene intimo 
- intimate intolerabel - intolerable introduccion 
- introduc¬ tion introduci 
- to introduce inunda 
- to inundate to flood inundacion 
- inundation  inutil jaloers inutil 
- useless invacion 
- invasion invadi 
- to invade invalido 
- invalid inventa (een-ven-tah - to invent inventario 
- inventory invento 
- discovery invention investiga 
- to investigate investigacion 
- inves¬ tigation invencibel 
- invincible invisibel 
- invisible invita 
- to invite invitacion 
- invitation involve 
- to involve irita 
- to irritate iritacion 
- irritation irlanda - ireland insist! 
- to bind isla 
- island italia - italy italiano - italian ivoor 
- ivory j jaag 
- to hunt jaagdor 
- hunter jabi 
- key wrench j acomenchi 
- a white person jaga 
- wound sore jaja 
- a nurse for children jaloers 
- jealous  jama juda iama 
- to call com jama bo - what^s your name ? iama ajo - to say good¬ bye jama 
- called jamada 
- summons jam 
- yam janga 
- to wiggle 
shake up januari 
- january japon 
- night¬ dress jechi 
- pick jega 
- to arrive to reach placa no ta yega - money is not sufficient jegamentu 
- arrival jeje 
- cicada jeje di awa - dragon fly jen 
- full jena 
- to fill jenever 
- gin jen-jen - brimfull jerba 
- grass jerba di hole - garden balsam jerba stinki - thorn apple jerba di bientu - wind grass jewa 
- mare jobe 
- to rain jobida 

- rain rainy season jola 
- flat buttons jongota 
- to squat down jora 
- to cry joramentu 
- crying jorki 
- dried salted goat meat jiu yiu 
- child jiu di afo - illegitimate child jiu-homber - son jiu-muhe - daughter juda yuda 
- to help  juda keiru juda mda 
- helped judanza yudanza 
- help aid juli 
- july juna 
- to fast juwana 
- iguana k kabel 
- cable kaiman 
- cay¬ man kajuit 
- cabin 
kakebein 
- jawbone kalki 
- lime kamber 
- room kampioen 
- champion kanchi 
- side kantu 
- side kantu di awa 
- water edge kap - to chop kapstok 
- hat-rack kashi 
- cabi¬ net katrol 
- block and tackle kaw 
- to chew ke kier 
- want need keda 
- stay remain keda ketu - be quiet keda atras - stay over stay behind keda cu 
- to keep retain keda mira 
- keep looking to gaze at keha 
- to-com- plain to grumble kehador 
- growler kehamentu 
- moaning com¬ plaining keho 
- complaint keinta - to heat warm keinta - heated warmed keintura 
- fever keiru 
- to stroll  kelki kini-kini kelki 
- chalice wineglass ken kende - who kenchi 
- chin kens 
- doting foolish kenter 
- to turn over kere 
- to be¬ lieve to think kerementu 
- belief kerido querido 
- dear kerki 
- pro¬ testant church kerosin 
- kerosene keshi 
- cheese keshi buricu - cheese made locally keshi comina - spiced cheese ketel 
- kettle ketu 
- quiet ketu-ketu - very quiet keur - inspect ki qui 
- what kibra 
- to break kibra 
- broken kibramentu di cabes - to break one's head kico kiko 
- what kico 
- with what ki dia 
- when what day ki hende 
- who kier ke 
- will want need kil 
- keel kilo 
- kilo¬ gram kilometer - kilometer kima 
- to burn kimamentu 
- burning fire kimica 
- chemistry kimona 
- kimona kiniki 
- marble 
kini-kini - chicken thief 
kinina krekeche kinina 
- quinine kinipi 
- to pinch kinipi wowo - to blink to wink ki ora 
- what hour how late when kiriwichi - crumbs kishiki 
- to tickle kita 
- to take off to remove kita animo 
- to discourage kita panja 
- to undress kita sombre - to take off hat kitoshi 
- wagon kizas quizas 
- perhaps kla 
- ready klap - clap pushbutton klapchi 
- fire-crackers klei - clay klerchi - hole dimple klier 
- gland kliste 
- anemia kloks - to cluck klompi 
- wooden shoe kloshi - spool kluif - to gnaw knichi 
- timber of a boat knolchi - radish kodak 
- kodak koek kuki 
- cake kokki 
- cook komchi 
- bowl cup komchi cu skottu - cup and saucer komkomber - cucumber konkel - to wind meander koor 
- choir koppi - cup koster - sexton koziin - window or door sill kraak - to crack kramp - cramp kreef 
- lobster krekeche - to shuffle  itrenchi lamper krenchi 
- a little a small por¬ tion kribchi 
- crib krijt 
- chalk kriki 
- cricket krimp 
- to shrink kwashi 
- knot brush l laat 
- late laba 
- to wash laba morto - lay out 
compose laba 
- washed labadera 
- laundress labanderia 
- laundry laboratorio 
- laboratory lachi 
- drawer ladron 
- thief ladronchi 
- lantern ladronisio 
- theft swindle laf - silly laga larga 
- let laga bai 
- let loose let go laga cai 
- let fall laga pa 
- to leave for laga para 
- let alone lagadishi 
- lizzard lagrima 
- tears lagun 
- lagoon lak - sealing-wax laker laken - sheet lam - lame laman lamar 
- sea lamanta 
- to get up to arrive lamper - lightning  lamchi lenga lamchi 
- lamb lampi 
- lamp lamunchi 
- lemon lana 
- wool lancha 
- launch landa 
- to swim lanta 
- to lift to raise get up awake lamtamento 
- withdrawal lanterna 
- lantern lansa 
- to lance lapi 
- rag larga laga 
- to let largu 
- long largu bai - straight ahead largura 
- length larva - larvae laster - leprosy lastra 
- to drag lata 
- blot¬ ches on skin latitud 
- latitude lauw - luke-warm lebe-lebe 
- slippery lechi 
- milk legal gay-gahl) - legal lehitima 
- to legalize lehitimo 
- legal legitimate lawful legalmente - legally legitimately lei 
- to lead leis - last 
lei di orea - earlobe lelie 
- lily lema lay-mah) - moth lembe 
- to lick lenga 
- tongue lenga - tongue 
of a bell  r i lensu lensu 
- hand- kerchief leon 
- lion lepi-lepi 
- limp lepra 
- lep¬ rosy lepros 
- leper les 
- lesson lesa 
- to read lesado 
- reader lesna 
- desk letter - jetter leu-leu 
- far leun - to lean against ley 
- law liber 
- pound free off liberacion - liberation liberal - liberal liberta 
- to liberate to free libertad 
- liberty freedom libertador 
- liberator libra 
- freed liberated lidia 
- case solicitude liga - bandage garter lihe 
- quick lihe 
- be quick liheresa 
- quickness agility lijshi 
- frame likdoor 
- com 
lila 
- lilac limita 
- to limit limonada 
- lemonade limosna 
- alms limpi 
- clean limpia 
- cleaned limpieza - cleanliness linial 
- ruler linja 
- line liquida 
- to liquify lista 

- list lista lista lista 
- list literatura - literature lizenbein - centipede lo - will shall lobchi 
- strip slip band tape lobo 
- wolf local 
- local localisa 
- to localize locha panja - to wash clothes loco 
- crazy mad insane loco pa - crazy about locura 
- craziness lodo 
- mud loer 
- to peep loga 
- place logica 
- logic logico 
- logical logra 
- to succeed logra di - to succeed lok 
- to entice loke 
- that which - luga lomba 
- back lombra 
- to glitter to shine lombrishi 
- navel iona 
- can¬ vas lontina 
- watch chain lora 
- to roll lora - parrot lorada 
- bend winding los - loose loteria 
- lottery loto 
- lotto game lubida 
- to forget lubidado 
- forgetful ab¬ sent-minded lucha 
- to struggle luga 
- place luga 
- in place of  luho maishi luho 
- splen¬ dor pomp luhoso 
- magnificent pompous luna 
- moon month lus luz - light duna luz - to give birth lusa luza - to illuminate expose lusafer 
- match m ma 
- but maart - march macacu 
- ape monkey macacu 
- mimicry macacu baboon - baboon macamba 
- hollander machete 
- cutlass cleaver chopper machica 
- to crease crumple crush machu 
- male animal macutu 
- basket madrasa 
- step-mother madrino 
- god-father magistrado - magistrate magneet 
- magnet magnetisa - to magnetize maha 
- to nag bother mahadero - bore mahado 
- bore mahamentu 
- boredom mahestad 
- majesty mahok 
- maho¬ gany mahos 
- ugly mahoso 
- ugly mai 
- mom mainta 
- morning maishi 
- maize corn  maishi chikitu dialucu maishi chikitu 
- small corn indian corn maishi rabu 
- guinea corn indian millet maishi tota - popped corn majan 
- tom¬ orrow majan mainta - tomorrow morning majo major 
- parent majo di edad - of age majoria - major majoria 
- majority majorida - majority majornan 
- parents mal 
- bad malbu 
- marble mal contentu - dissatisfied mal cria 
- ill-bred maldicion 
- cursed maldiciona 
- to curse mal di pechu 
- t. b. mal ehempel - bad example malesa 
- illness sickness maleta 
- suitcase mal gradicido - ungrate¬ ful mal hende 
- bad person malicioso 
- malicious mal lenga 
- obscene language mal mucha (moo-chah - naughty child mal muerte 
- miserable mal suerte 
- bad luck maltrata 
- ill-treated maltrato 
- ill-treatment malu 
- sick ill bad malucu 
- naughty  mama manita mama 
- mother mama 
- to g-qcklc mamaja 
- mamey 
mamaluk - children's night dress man 
- hand man 
- to shake hands man 
- on hand in stock manca 
- mis¬ sing wanted mancaron 
- faulty defective mancha 
- stainless mancha 
- stain spot mancha 
- stained spotted manda 
- to send to order to command manda busca 
- to order manda duro 
- to drive fast hard manda leu 
- to administer narcotics anesthetic mandamentu 
- command¬ ment manda raua 
- to irradiate maneha 
- to steer to manage direct manera 
- manner way like manera 
- without manners manga 
- sleeve mangel - candy mangrove mangel 
- date tree mangera - hose 
mania 
- mania manifesta 
- manifest manifestacion - mani¬ festation manise 
- to dawn manita 
- dawn daybreak morning  manja marina manja 
- cap¬ rice whim fancy freak mansa 
- to knead manshet .
- cuffs 
mansu 
- tame manteca 
- butter manteca di bela - candle grease matamentu 
- murder maticula 
- to naturalize matrimonio 
- matri¬ mony matris 
- womb matroos 
- sailor maximo 
- maximum manteca di wesu 
- marrow manteca dushi 
- cream butter mantel - cloak mantene 
- maintain vindicate keep up mantenacion 
- maintenance mapa 
- map chart mara 
- if it were only true i wish it were true maraca 
- rattle marca 
- mark marca 
- to scratch to mark marcha 
- march marchanite - customer marga 
- bitter maribomba 
- wasp maria 
- to vomit maria - seasick maria 
- mary mariamentu 
- sea-sick¬ ness marina 
- marine  mehor r marinero marinero 
- seaman maron 
- brown marra 
- to tie marra 
- tied marra na - tied to in love with marshe 
- mar¬ shal martin 
- ham¬ mer martir 
- martyr mas 
- more mas 
- too much mas acerca - closer nearer mas biaha - several times mas miho 
- best mas parti 
- mostly masca 
- to chew masticate masculine 
- masculine masha 
- very much masha bunita - very pretty mashin 
- machine mashin di conta - adding machine mashin di skirbi - type¬ writer maske 
- though although mason 
- free mason masoneria 
- free masonary master 
- mast mata 
- to kill mata 
- plant mata 
- killed mea 
- sock stocking mecanico 
- mechanic mecha 
- wick medaja 
- medal medajon 
- medal medicina 
- medicine medida 
- measure meen 
- to mean meester 
- master mehor miho - better  mehora meskinja mehora 
- to improve to get better mei - half mei-mei - middle between mei - may melodia 
- melody memorabel 
- memorable memoria 
- memory menasa 
- to threaten menasa - threat menciona 
- to mention mengua 
- to decrease to lessen mengua 
- de¬ creased to cut out to reduce menos - less menosprecia 
- to dispose menosprecio 
- contempt scorn mensual 
- monthly menta 
- men¬ tion name menta 
- men¬ tioned named ariba menta - above- mentioned mentalidad 
- mentality mentol 
- men¬ thol merca 
- america mercancia 
- merchandise goods merdia 
- af¬ ternoon merece 
- to merit mericano 
- american merito 
- merit award mes 
- same self mi mes - myself mesa 
- table mescos 
- the same mescos cu 
- the same as meskinja 
- greedy  mesla mingua mesla 
- mason bricklayer mes 

- him¬ self herself itself mes ora 
- at once directly at the same time mes tantu 
- as much equally mest - manure mester meste 
- must need metal 
- metal meter 
- meter meubel - furniture muebla 
- to furnish 
mezcla 
- to mix mezcla 
- mixed mi 
- i me my microbio 
- microbe midi 
- to measure midi 
- measure measured miedo 
- fear miedo 
- without fear miembro 
- member mientras - while mientras tanto - in the meantime miho 
- better mija 
- mile mijar 
- mil¬ liard mijo miho 
- better mil 
- thousand milager 
- miracle wonder milagroso 
- miraculous militair - military milon 
- melon mimo 
- touchy easily hurt mina 
- mine 
mina di oro - gold mine mineral 
- mineral mingua 
- to decrease to lessen  miniatura nioketa miniatura 
- miniature ministerio - ministry ministro 
- minister minuut - minute mira 
- to look see misa 
- church miserabel - miserable miseria 
- misery misericordia 
- compassion pity mishi 
- to touch to meddle with mishi cu 
- meddle with misionario - missionary mispu 
- mes- pel 
misterio 
- mystery misterioso - mysterious mitar 
- half mobilisa 
- to mobilize mobilisacion 
- mobilization moca 
- sledge hammer mochi 
- slice of meat moda 
- method style way model 
- model modera 
- to moderate moderacion 
- moderation moderado 
- moderate modernisa 
- to modernize modemisacion - moderni¬ zation moderno 
- modern moer 
- nut 
mofa 
- to tease to make fun of moha 
- to wet muha moha 
- wet mohe muhe 
- woman muher moketa 
- fist  moketa _mozaico moketa 
- to thump mokete 
- blow with the fist fist molester 
- to molest to tease to trouble to annoy molesto 
- trouble moli 
- soft momentu momento 
- moment monarkia 
- monarchy mondi 
- forest woods mondogo 
- entrails monogram - monogram monopolio - monopoly monopolisa - to mono¬ polize monster 
- monster monta 
- to advance in price monumental - impressive grand imposing monumento - monument moral 
- moral moralidad 
- morality morcoi 
- tor¬ toise morde 
to bite morfina 
- morphine mors 
- to mess make a mess of mortal 
- mortal mortifica 
- to mortify morto 
- dead corpse morto violente - death by violence mosa 
young lady 
waitress mosterd - mustard motibu motibo 
- motive reason move moof - to move movementu - moving movibel - movable mozaico - mosaic  mucha mutica mucha 
- child muchachada - boyish childish mucha homber 
- boy mucha malucu - naughty child mucha-mucha - very young childish mucha muhe 
- girl muchu 
- much plenty muda 
- dumb muestra 
- sample mujete 
- sledge mula 
- to sharpen mula 
- mule mulina 
- mill mulina di carni - meat- grinder multiplica 
- to mul¬ tiply multiplicacion - to multiply multipli¬ cation mundo 
- world municion - ammunition munstra 
- to show muraja 
- wall muri 
- to die muri df 
- to die of muri di hamber 
- to die of hunger muriendo 
- dying musculo 
- muscle muskita 
- fly muskitero 
- mosquito net mustashi 
- mustache mustra 
- to show mutica 
- to mutilate  nabegacion na n na 
- to by in at na bida 
- alive na bista 
- in sight na caminda 
- on the road nacionalista 
- na¬ tionalist na estado 
- pregnant na flor 
- in bloom na gustu 
- at your desire na juna 
- fasting na man 
- on hand in stock na mes manera - in the same way na mes tempu - in the same time na nomber - in the name of na ora - on time na orde - in order na otro camina 
- in another place na otro manera 
- in another way na otro parti - to another place na principle 
- in the begin¬ ning na propocion 
- in proportion na publiek 
- in public na sanger 
- in blood na tempu 
- on time na tino 
- conscious na tur camina -every¬ where na uso 
- in use nabaha 
- razor nabega 
- to sail navigate nabegacion 
- navigation  nabegante nenga nabegante 
- seaman nace 
- born to be born nacemento 
- birth nace morto - born dead nachi 
- seam nacion 
- nation nacional 
- national nacionalidad 
- natio¬ nality nada 
- nothing naker 
- mother- of-pearl nan 
- they their them nanishi 
- nose nanzi 
- spider natura 
- nature disposition natural 
- natural natividad 
- nativity naturaliza 
- naturalize naufragio 
- shipwreck naufrago 
- one that is shipwrecked necesario 
- necessary necesidad 
- necessity nechi 
- neatly nicely nechi 
- nut 
neerlandees - netherlander neger 
- negro negosia 
- to do business nego¬ tiate negociante 
- merchant negoshi 
- business negrita 
- negress nek 
- to beguile trick take in nek 
- neck nenga 
- to re¬ fuse  nenga nobo nenga 
- refused nengamentu - refusal nervio 
- nerve nerviosidad - nervousness nervioso 
- nervous neshi 
- nest net - exactly just precisely neutral - neutral neutralidad - neutrality neutraliza - neutralize ni 
- neither nicotina 
- nicotine nier 
- kidney niester 
- to sneeze nietu 
- grand¬ child nifica 
- to signify nificacion 
- significance meaning nikel 
- nickel nikla 
- to nickel ningun 
- no one not one ningun hende - no one niptang - pincers njapa 
- tip no 
- no no mishi 
- keep away don’t touch no abstanto 
- not withstan¬ ding no permiti 
- prohibited noa 
- anger noa 
- at variance in disagreement at odds noa cu 
- vexed with angry with noamentu 
- anger vexation disagreement nobel 
- noble nobenta 
- ninety nobleza 
- nobility nobo 
- news nobo 
- 
- anew  nobo-nobo oba nobo-nobo 
- spick and span brand new noche buena - christmas night nochi 
- night nocion 
- notion nodi 
- needed necessary nomber 
- name nomber 
- in the name of nombra 
- to appoint nombramentu - appointment noms 
- odd nort noord - north nos 
- we us our nota 
- to ob¬ serve to note nota 
- note notabel 
- notable considerable notario 
- notary noticero 
- reporter 
noticia 
- news notice novedad 
- novelty novel 
- novel novelista 
- novelist november - november no vena 
- novena no vis 
- novice nubia 
- cloud nuebe 
- nine numa 
- never mind bai numa - never mind go numero 
- number numera 
- to number numeroso 
- numerous nunca 
- never o o 
oba 
- a kind of plum  obedece oficiaimento obedece 
- to obey obedecido 
- obedient obheto 
- object objeccion 
- objection obliga 
- to oblige to compel obligacion 
- obligation obliga di 
obliged to obligatorio 
- obli¬ gatory obra 
- work obrero 
- workman laborer obscuro 
- dark obscure obserba 
- to observe observacion 
- obser¬ vation observatorio - observa¬ tory obsipo 
- bishop obstante 
- not withstanding obtene 
- obtain ocasion 
- occasion ochenta 
- eighty ocho 
- eight october - october oculista 
- occulist eye specialist ocupa 
- to occupy odia 
- to hate odio 
- hatred ofende 
- to offend ofensa 
- offence oferta 
- to offer oficial 
- official oficiaimento - officially  oficina ordinario oficina 
- office ofishi - trade skool di ofishi - trade school ofrece 
- to offer ohochi 
- twin oibel 
- audible oido 
- hearing ola 
- gulf wave oleanda 
- oleander 
oliba 
- olive tree olijfe 
- olive oloshi 
- watch clock olor olo holo - scent smell odor onbeskop 
- rude impolite fresh oost - east opcion 
- option opera 
- operate opera - opera operacion - operation opina 
- to be of the opinion opinion 
- opinion opio 
- opium opone 
- op¬ pose oposicion 
- opposition optico 
- optical optimista 
- optimistic ora 
- hour when ora cu 
- then when oracion 
- prayer orador 
- orator orcan 
- hur¬ ricane orde 
- order ordena 
- to ordain order 
- com¬ mand order ordinario 
- ordinary  orea padrino orea 
- ear orea cera 
- hard of. hearing orea duro 
- disobedient organisa 
- to organize organisacion - organization organista 
- organizer organ player 
orgujo 
- proud vain orienta 
- orientate original 
- original orihen 
- origin orina 
- to urinate orkestra 
- orchestra oro 
- gold oro bati 
- gold leaf otro 
- other otro dia - recently the other day otro majan 
- day after tomorrow otro parti 
- somewhere else ovacion - ovation oval 
- oval oxida 
- to rust p pa 
- for through paai 
- papa pa bao 
- west to the west pa beneficio di - to the benefit of pa bien - congratulations pa caualidad - casually pachuela 
- thumb tack pacus 
- store pa dilanti 
- forward in front pa di prome 
- in the first place padrasa 
- father-in-law padrino 
- godfather  pa motibu di pa motibu di - for reason of pa e motibu 
- for that reason pa esaki - here-to-fore pa esei - therefore paga 
- to pay to erase to extinguish pa fortuna 
- fortunately paga 
- paid pagai 
- paddle pagamentu 
- pay paga tino 
- pay attention paginismi - paganism pagina 
- page pago 
- pay wages pagot 
- scape¬ goat pais 
- land country paisano 
- countryman paketa 
- to pack pakete 
- package pakico 
- why palabra 
- word palabra di honor - word of honor palabrua 
- owl palacio 
- palace palanca 
- lever palangana - wash basin palco 
- gallery 
palmit 
- palm 
palomba 
- pigeon palomba gai - cock pigeon palu 
- tree wood stick ’ palu di bandera 
- flag-pole palu di boonchi - balsa wood palu di coco 
- coco-palm  paraha palu di cortina 
- curtain rods palu di dader 
- date tree palu di fruta 
- fruit tree^ palu di maishi 
- maize plant palu di pia 
- shin palu di seda 
- cedar tree 
pampuna 
- pumpkin pan 
- bread panaderia 
- bakery panadero 
- baker pan bati 
- maize bread with sugar etc. panchi 
- tile panja 
- cloth clothes panja di bela 
- canvas panja di hilu 
- linen panja 
- 
- to change clothes pantomina 
- pantomine papa 
- father porridge pope papa moha 
- wet through papaja 
- papaya papel 
- paper papel di glas - sand paper papel di secu - blotter papia pah-pee-ah) - to speak to tell papiado 
- 
- talker papia malu di - to speak ill of papiamentu 
- talk papiamento - papiamentu par 
- pair para 
- to stand stop bird paraha para 
- bird  paralisa pasta paralisa 
- paralyzed para poco - wait parasol 
- umbrella parasol di zumbi - mushroom para un pinga 
- wait a while pari 
- to give birth to bring forth pa riba - east eastward parki 
- park parokia 
- parish parti 
- part parti 
- par¬ ted divided particular - particular partida 
- party partimentu - distribution parto 
- deli- very confinement pas - to fit to try on pasa 
- crazy stupid foolish pasa 
- to pass ago pasa bai 
- keep going pasahero 
- passenger pasa na awa - boiled 
pasa nochi 
- to spend the night pasa pa 
- go through pasashi 
- passage pasa tempu 
- spend time paso 
- stride step pascu di nacimentu - christmas pascu di resurreccion - easter pasenshi 
- patience paskin 
- to fade paskin 
- an- nonymous letter pasion 
- passion pasobra 
- because pasport - passport pasta 
- paste  patechi peligroso patechi 
- pastry meat pie pastija 
- tablet pastoor 
- pastor pata 
- hoof leg . pata di cabai - horse¬ shoe patent 
- pa¬ tent patenta 
- to patent paternal - paternal patia 
- watermelon patras 
- be¬ hind backwards patria 
- fatherland patriarca - patriarch patriotismo - patrio¬ tism patu 
- duck pausa 
- pause pawis 
- pea¬ cock paz 
- peace peca 
- to sin pecador 
- sinner pechi 
- cap pechu 
- chest pedal 
- pedal pega 
- to stick pega 
- stuck pega barcu 
- to put a ship ashore pega candela 
- to set fire pega luz 
- to turn on the light pega sonjo 
- to fall asleep pekel 
- pickled herring pela 
- to have a hair cut pela 
- cut pelea 
- a fight battle pelea 
- to fight pelicula 
- film picture peliger - danger peligroso 
- dangerous  pena perfecto pena 
- to suf¬ fer penchi 
- pic¬ ket pendiendo - pending penetencia 
- penance penetencia 

- do penance penetra 
- to penetrate penetracioa - penetration penitente 
- penitent penja 
- comb pens - tong pensa 
- to think pensa 
- thought pensamentu 
- thought penseel 
- pen¬ cil artist brush pension 
- pen¬ sion pension - boarding house peon 
- laborer pepe 
- god¬ mother peper 
- pep¬ per pepita 
- seed pera 
- pear pera di luz 
- a light bulb percura 
- to take care of perdamentu 
- loss perde 
- to lose perde abla 
- to become speechless perde caminda 
- to lose the way perde color 
- to fade lose color perde san juan - to sleep in oversleep perdi 
- lost perdida 
- loss perfeccion 
- perfection perfecciona 
- to perfect perfecto 
- perfect  perform pica perfora 
- to perforate perfuma 
- to perfume perfuma 
- perfume perhudica 
- to harm to hunt periodista - journalist periscoop - periscope perla 
- pearl permanente 
- permanent permiso 
- permission permite 
- to permit to allow pers - to squeeze to press persecucion - persecution persigi 
- to pursue persist! 
- to persist to perse¬ vere persona 
- person personal 
- personal personalidad - persona¬ lity persuadi - persuade pert a 
- to pinch to squeeze pert a 
- narrow tight pertenece 
- belong to p'esaki - here for pesebre 
- crib p'esei - therefore puishi - pimple peso 
- weight pest - plague pestar - to plague to pester pete 
- stupid peticion - petition re¬ quest petrechi 
- necessities pia 
- foot leg pia abao 
- barefoot pica 
- to bite to sting pica 
- sting sin  pica pinda herebe pica 

- to sin pica mortal - mortal sin pica original - original sin pichiri 
- greedy mean niggar¬ dly pichon 
- a yoimg pigeon pida 
- piece pidi 
- to beg to request to ask for to order pidi limosna 
- to ask for alms pidido 
- beggar pidimentu 
- begging piedad 
- piety piedra 
- stone piedra di candela - fire¬ stone flint piedra di mula 
- grind-stone pieu 
- louse pieza fpee-aye-sah) - piece of music pik 
- beak piki 
- to pick up piki 
- pickaxe piki pieu 
- dot one’s ’i’s’ piki punta 
- to attend drinking parties pil 
- to make a fool of pilar 
- pil¬ lar column pildora 
- pill tablet pilon 
- a large jack screw pilote 
- pilot pinchi 
- pint pinda 
- peanut pinda hasa 
- roasted peanuts pinda herebe 
- boiled peanuts  pinga plan pinga 
- a morsel pinga 
- to drizzle pinta 
- to paint pinta 
- drawn painted pintor 
- painter artist pio 
- worse pipa 
- pipe pipita 
- seed pis 
- violet purple pisa 
- to weigh pisa 
- heavy pisca 
- to fish pisca corra - red snap¬ per pisca gengu - begone piscalet - prison jail piskechi 
- small fishes fry pita 
- to blow a horn or whistle pitu 

- whistle placa 
- money placa di buelto 
- currency change placa di papel - paper currency placa legal - legal cur¬ rency plachi 
- pic¬ ture placentero - pleasant joyful merry plafon 
- ceiling plaja 
- flat land beach shore strand plaja 
- oran- jestad town plak 
- to stick plaketa 
- stuck plama 
- to scatter to spill plama 
- scat¬ tered spilt plama panja - to run away unobserved plan 
- plan  plan bari 
- empty-handed plancha 
- plate metal sheet plancha di diente - a set of false teeth plancha di heru 
- sheet iron planchi 
- plant planta 
- to plant planta 
- plant 
planta di man - palm of the hand planta di pia - sole of the foot plate 
- sil¬ versmith platina 
- platinum plecha 
- flatten crush plecha 
- flat¬ tened crushed plega 
- to curse plega 
- cursed doomed pleister 
- plaster pleita 
- to argue to quarrel pleitista 
- a quarrelsome fellow pleitu 
- quarrel plezier - pleasure ploeg - plough plooi - wrinkle fold pleat crease pluma 

. to remove the feathers of a bird pluma 
- to moult pluma 
- feather pober 
- poor pobercito 
- poor wretch pobla 
- po¬ pulate poblacion 
- population pobresa 
- poverty poco 
- little  diapasa porcion poco poco dia pasa ■ a fw days ago poco tempu pasa - short time ago poco-poco - slowly poder 
- power poderoso 
- powerful podise 
- perhaps poeiru - face powder pushi 
- cat polaco - pole polber 
- gun¬ powder polechi 
- chicken polier 
- to polish polis 
- police cop pomp - pump to pump ponchera 
- washing tub ponchi 
- ferry¬ boat pontoon ponchi crema - eggnog pone 
- to put place pone atencion - to pay attention pone beslag - to seize pone di haci - to oblige compel pone man - to interfere intervene put hand on pone mesa - to lay the table pone tino - to pay atten¬ tion popchi 
- doll popchi di wowo - eye¬ ball popo 
- dried meat popular 
- popular por 
- can may por fin 
- at last por nada 
- in vain por ta 
- may¬ be ips possible por wanta 
- able to porcion 
- quantity  porco practico porco 
- pig swine hog porco di spinja - por¬ cupine pardon 
- pardon pardona 
- to pardon forgive pai'donabel - pardon¬ able porcoria 
- dirt filth poron 
- jar pitcher porselein 
- porcelain por supuesto - of course porta 
- door portmone 
- wallet portret 
- portrait portret saca - take pic¬ tures portugal - portugal portugees - portuguese porvenir 
- future posa 
- to lodge to board in a hotel posecion 
- possession posede 
- to possess pos 
- well posibel 
- possible posibilidad 
- possibility posicion 
- learning position positivo 
- positive pospone 
- to defer postpone postema 
- ulcer boil postkantoor - post office potencia 
- power potency potente 
- powerful potent potlood 
- pen¬ cil 
potoshi 
- rubbish practica 
- practice practice 
- practicable  presta r nraga praga 
- plague praktijk 
- practice preba 
- to prove precioso 
- precious precision 
- precision preciso 
- exact precise predica 
- to preach predicashi 
- sermon preekstoel - pulpil prefera 
- to prefer preferencia 
- preference pregunta 
- question preimu 
- plum premio 
- prize prenchi 
- pic¬ ture prenda 
- jewel presa 
- press 
prestamo 
- loan preocupa 
- troubled prepara 
- to prepare preparacion 
- prepara¬ tion presencia 
- presence presencia di spiritu - presence of mind presencia 
- to attend present 
- present presenta 
- to offer present preserva 
- preserve presidente 
- president chairman presidi 
- preside presion 
- pressure presta 
- achieve accomplish  presta probecha presta 
- to lend prestige 
- prestige presu 
- prisoner preta 
- prevented pretende 
- to pretend claim pretu 
- black preveni 
- prevent prijs 
- price prikichi 
- parakeet prima 
- cousin niece primi 
- to press to pinch primeramente - primary priminti 
- to promise primitive 
- primtive prime 
- cousin nephew principal - principal chief principia 
- beginning principio 

- original first in¬ tended at the begin¬ ning prins - prince prinses - princess prison 
- prison jail privilegia 
- to privilege privilegio - privilege proa - bow 
proba 
- to prove to show proba 
- proven probabel 
- probable probabilidad - probabi¬ lity probacion 
- probation probecha 
- to profit from utilize make use of  t)robecho pronuncia probecho 
- profit benefit advan¬ tage probechoso 
- profitable advantageous problema 
- problem procesion 
“ procession proceso 
- process procidimento 
- proce¬ dure proclamacion - proclama¬ tion proclema 
- proclaim produccion - production produci 
- to produce profesion 
- profession prof eta 
- prophet profetisa - to prop¬ hesy profia 
- stubborn prof undo 
- profound deep progashi purgashi - purgative progreso 
- progress prohibi 
- to prohibit prohibicion - prohi¬ bition prohimo 
- neighbor prolonga - to lengthen prome 
- first before prome aja - formerly prome cu - formerly previous to before promente dushi - pap¬ rika promesa 
- promise promocion 
- promotion pronk - show pronto 
- soon pronuncia 
- to pronounce  pronuncion pronuncion - pronun¬ ciation propoga 
■ propagate proposicion - proposi¬ tion propaganda - propaganda propiedad - ownership property possession propone 
- propose pi oporcion - proportion proposicion - proposi¬ tion prostitucion - prostitution proteccion - protec¬ tion proteha 
- protect protest 
- protest protesta 
- to protest protestant - protes¬ tant proverbio 
- proverb providencia - provi¬ dence provision - provision  provoca 
- to provoke to tease provocacion 
- provoca¬ tion prueba 
- proof token evi¬ dence pruga 
- flea publica 
- to publish publicacion 
- publica¬ tion publiek 
- public pudin 
- pud¬ ding pudor 
- sense of shame pueblo 
- people folk nation puesto 
- post position pujito 
- chicken pulchi 
- powder 
pulmon quier pulmon 
- lung pulmonia 
- pneumonia puls - pulse pulsera 
- bracelet pulushi - jealous pulverisa - pulverize punja - dagger punta - point end punta 
- pointed puntra 
- to ask punctual - punctual pura 
- to hasten to hurry pura 
- hastily hurriedly purba 
- to taste to try puresa 
- purity purifica 
- to purify purificacion - purifi¬ cation pursi 
- can i can he etc. pursugi 
- pursue puru 
- pure pus 
- pus pusha 
- to push pusta 
- to bet wager putri 
- rot¬ ten spoiled decayed putri di hari - to laugh heartily puus - purple q queda keda - stay remain quemica - chemistry quemico - chemist quen ken 
- who quende kende 
- who quere 
- think believe queshi keshi 
- cheese qui 
- what 
quico kiko 
- what quier kier ke - want  raal realiaciti r raai 
- to guess raak 
- touch raampi di glas - glass window raar 
- strange rare rabia 
- anger rabioso 
- angrily rabu 
- tail racion 
- ration raciona 
- to ration radiator - radiator radical - radical radio 
- radio lais 
- root rajo 
- ray rama 
- bran twig ranca 
- to pull jerk tug snatc] ranca afo - to pull out ranca sanger - to suck out blood rango - range rank rasca 
- to scratch to scrape rasca 
- scratched rascu 
- scratch scrape rasenchi - raisin raspa 
- to grate rasp raspu 
- rasp raton 
- mouse raton di anochi - bat ratu 
-a while a moment warda un ratu - wait a while raza 
- race razon 
- reason razon 
- to be right razonabel - reasonable reacion - reaction real 
- royal realidad 
- reality realiza 
- realize realizacion - realiza¬ tion  rebaha reforma rebaha 
- to give amount rebaha 
- discount rebulta 
- to turn over capsize recet 
- pres¬ cription rechasa 
- to drive back recibu ricibu 
- receipt reciente 
- recent recientemente - recently reclama - to reclaim reclamacion - reclama¬ tion reclame 
- reclaim recohe 
- recapture recomenda 
- recommend recomendabel - recommen- dable recomendacion - recommen¬ dation recompensa - reward compensate reconoce 
- to acknowledge reconocementu - acknow¬ ledgement record 
- record recorda 
- to remember recreo 
- recreation recrutamento - recruiting rectitud - honesty rectifica 
- to rectify recuerdo 
- rememberance gift reda 
- to tell tales disclose redaccion - editorship redactor - editor redentor - redeemer redobla - redouble reduci 
- reduce referenda - reference referenda - reference refer! 
- refer reforma 
- reform  reformacion reformacion - reforma¬ tion reforsa 
- to strenghten refresca 
- refreshen refresco 
- refreshment refn 
- re- feree refurzo 
- strength refugio - refuge re¬ course regala 
- to present regalo 

- present regia 
- to arrange straighten out regia 
- line rule regular 
- regular rehabilita - to exonerate rei 
- king reina 
- queen reino 
- kins'- dom rek 
- to stretch rekki 
- rack relacion 
- relation relaciones industrial - industrial relations religion 
- religion religioso 
- reli- gous relohero 
- watch¬ maker rema 
- to row remedi 
- remedy medincine rementa 
- to burst to explode renoba 
- to renovate rens - rancid repasa 
- review repi 
- strip representa - represent  representacion - repre¬ sentation representante - repre¬ sentative reputacion - reputation rees 
- lard requerimente - require¬ ment resa 
- to pray resamentu - prayer resedencia - residence reserba reserva 
- to reser-ve reserba 
- reserve resicito - resurrect resida - mignonette resistencio - resis¬ tance resist! 
- to resist resolbe 
- to resolve resolucion - resolution resona 
- to resound respet 
- respect reuni respeta 
- to respect respetabel - respectable responde 
- answer respond! 
- answer responsabel - respon¬ sible responsabilidad - res¬ ponsibility respu 
- to belch restitucion - restitu¬ tion restitui - to restore resto 
- rest remainder resulta 
- to result resulto 
- result resureccion - resur¬ rection retira 
- to retire retiro 
- discharge retirement reuni - to assemble  reun^n^. „eeting ses- ^®vela 
. to reveal ss;°” ' relation j^ovision - revision na 
-  ^ cents ^ riba 
- up above over on riba-riba - superficial nba tur 
above all ^ ribchi 
- rjb ncibj 
ricib?mentrr";esj”^^ communion ricu 
- rich ^ree-dee-koo- rif« r ; p'^iculous fsr^ - to raf- ritamentu (ree-fa }i rvi o • tnr.^ /- v^ran-main- ^ - raffle nkesa 
- hi ■ '^aalth  rinchi di orea - ear¬ rings ripara 
rinifi °*'®arve ripiti 
- . . to repeat sa^^f” - repetition risca 
- to venture riscu 

ture sstiw ■ ^®®tstauce risisti 
to resist rispu 
- to belch ristra 
- to search riu - river robes 
- left wrong rooster - to rust roga - to implore rol - roll rompecabes - puzzle ronipi - rump ron - rum ronca 
- to snore ronchi - a drive around - ven- saca portret rond rond - round rond di - around rondia 
- to seek to round up rondo - round about rondona 
- surround rooi - trench ditch gutter rooibiet - red beets rooster - to roast rosa 
- to clean off land rosa 
- rose rosario - rosary rosea 
- breath rosea 
- to breathe rouw - mourning rubi 
- ruby rucu 
- coloring seed rudia rudija 
- knee ruleta 
- roulette rum - course direc¬ tion ruman-homber - brother ruman-muhe - sister rumor 
- rumor russia 
- russia ruta 
- route routina 
- routine s sa 
- to know sa 
- without knowing saania 
- mange sabana 
- swamp sabel 
- sword sabi 
- to know sabi 
- wise clever sabidura 
- knowledge wis¬ dom saca 
- to vomit take out put out erase saca cuenta 
- to write a bill saca portret 
- to take pictures  sacramento -► sacramento - sacrament sacrifica 
- to sacrifice sacrificio 
- sacrifice sacrilegio 
- sacrilege sacristia 
- sacristy sacu 
- sack bag pocket ^ sacu di papel - paper sack sagrado 
- sacred sagrado curazon 
- sacred heart 
sagudi 
- to shake sagudi rabu 
- to wag the tail saja saya 
- lady^s skirt saja di abao 
- lady^s slip sajet 
- satin sala 
- hall saloon salada 
- salad salaria 
- to pay a salary salario 
- wages salba 
- to save salvage salba 
- saved salvaged salbacion 
- salvation salbador 
- saviour salbahe 
- wild saiga 
- to salt saiga 
- salted sali 
- origin sali bon 
- to succeed turn out well sali malu 
- to fail turn out poorly spoil salinja 
- saltpond salmao 
- salmon salpeter 
- saltpeter  salta sarna salta 
- omit to leave out salta 
- omitted salu 
- salt salvo 
- salvo sambarcu 
- a kind of slipper sambechi 
- pocket-knife sambuja 
- to dive samina 
- to examine saminaccion - examina¬ tion sanciona - to sanction approve sancochi 
- soup from greens and vegetables sandalia 
- sandal sanga - excavation sanger 
- blood sanger friu - cold blood sanger 
- 
- in blood sanger puro 
- thoroughbred sangra 
- to bleed sangura 
- mosquito sanidad 
- cleanliness sanity santana 
- r.c. burial place santa olio - holy oil santifica 
- to sanctify santificacion 
- sanc¬ tification santu zantu 
- sand santuario 
- sanctuary sapate zapate 
- shoemaker sapatia 
- a swimming kick sapatu 
- shoe sapu 
- frog sara 
- provoke tease sarampi 
- measles sarna 
- teaser  sas 
- sawdust sastre 
- tailor sasteria 
- tailor shop satin 
- satin satisfaccion 
- satis¬ faction satisface 
- satisfy satisfecho 
- satis¬ factory sauchi 
- swallow sails 
- saucg sauseshi 
- sausage saxofon - saxophone scama 
- to re- moi^e scales from fish scama 
- scale 
scandal 
- scandal scandalisa 
- to scandaliz scandalosamente - sca:adalous scapa 
- to escape scapa 
- es¬ caped scapa di paga - evade payment scapabida 
- life-belt scapula 
- scapular scarmai - to skip stones on the water schaak - chess schrijnwerker - joiner furniture maker schutter - soldier of the civil guard sclama 
- to exclaim scohe 
- to choose to select to catch scohi 
- selec¬ ted caught sconde 
- to hide scondi 
- hidden scopet (
- gun  scops^ hag^ semana santu scopet di hagel - shot¬ gun scopet di jaag - hun¬ ting gun scorpion 
- scorpion scual 
- scolding squall scucha 
- to listen scupi 
- to spit scupi 
- saliva scupi di dios 
- birthmark scur 
- dark somber scuridad 
- darkness sea 
- be seba 
- to grease seba 
- greased sebu 

- grease seca 
- to dry seca 
- dried secretaria 
- secre¬ tary’s office secretario 
- secre¬ tary seereto 
- secret secu ( say-koo) - dry secura 
- drought sed 
- thirst seda 
- silk segun 
- ac¬ cording to segundo 
- according to seguro 
- certain sure seis - six seja 
- to seal seja 
- sealed sejo sello 
- seal seleccion 
- selection seliga 
- sail-thread semana santu - holy week  semanario semanario 
- weekly sembra 
- to pour sempel - sample semper 
- al¬ ways senja 
- sig¬ nal senjala 
- to signal senjora senora 
- madam senjorita senorita 
- miss sensacion 
- sensation sensacional - sensational sensual 
- sensual lustful vo¬ luptuous sentebibu 
- aloe sentencia 
- to sentence sentidi 
- meaning sentido 

- ambiguous mam-toh) - sentiment separa 
- to separate separacion 
- separation sera cera 
- to close to shut sera 
- closed sera boca cera boca - be quiet shut your mouth shut up sera cara 
- to frown sera cerca otro cera - close together sera cera moketa ^ make a fist sera na jabi cera na jabi - to lock serbete 
- towel serena 
- dew serenada 
- to serenade sentimental 
- sentimen¬ tal sentimento (sain-tee-  serio slgl serio 
- serious seriosidad 
- serious¬ ness sesenta 
- sixty severidad 
- severity severe 
- severe strict shafer chofer - chauf¬ feur shap - bar-room grocery shapero 
- bartender grocer shapogris 
- poorly dressed shawawa 
- badly dressed untidy sherta 
- reach attain sherta 
- at¬ tained shilet 
- waist¬ coat shimaron 
- nettle shimarucu 
- wild-cherry shimuhe 
- an effeminate fellow shinishi 
- ash shiri-shiri 
- entrails shishi 
- eldest sister shishi di caja - street woman shofer 
- driver shon 
- polite form for you he she. sir shorombu 
- comrade shoreta 
- to girdle shuata 
- poisoned by fish si 
- yes if si no 
- unless sea 
- saddle sibojo 
- onion siete 
- seven sigi sigui 
- continue go on  slgl sigi 
- con¬ tinued siglo 
- cen¬ tury sigur 
- sure certain sigura 
- assure ascertain siguransa 
- certainty siguridad 
- safety silaba 
- syllable silencio 
- silence silencion silencia - silence simadan 
- harvest siman 
- week siman di pascu 
- christmas week siman pasa - last week simija 
- seed simpatica 
- sympathy simpatico 
- sympathetic ___ sin dudfll simpel 
- sim- j pie ;i simplesa 
- i qualify | sin 
- without i sin animo 
- | without courage  sin berguenza 
- without shame  shameless i sin bida 
- | lifeless i sinceridad 
- i sincerity  sincere 
-  sincere | sin colo 

- i without color pale  sin consenshi 
- without conscience | sin cuenta 
- vj careless i tl sin curazon 
-  heartless | sincuria - straw hat | sin duda 
- doubt¬ less  fiinembargo sin talento sinembargo 
- not with¬ standing sinfonia 
- mouth-organ sinfonia di man - hand- organ accordion sin fin 
- endless sin fondo 
- unfounded sin forza 
- without power weak sin gastu 
- without expense free sin hera 
- without missing sin igual 
- without equal sin kita ni pone - li¬ terally sin laba 
- without washing sin mancha 
- without stain sin manera 
- without manners im¬ polite sin miedo 
- fearless sin nodi 
- not being needed sin penja 
- uncombed sin pensa 
- thoughtless without thinking sin ripara 
- without noticing sin sa 
- unconscious without knowing sin smaak 
- without taste sin sosiegu 
- without rest sin stop 
- without stopping sin strobacion 
- unimpeded sin talento 
- un- talented  sin tapa skeiru di sin tapa 
- uncovered sinja 
- to learn sinja 
- learned sijansa 
- education sinta 
- to sit sinta 
- ribbon sinta 
- sitting* sinta den placa - sitting on the money rich sinti 
- to feel sinti 
- feeling sense ’ sin sinti 
- thoughtless frivolous sintimentu 
- feeling sirbi 
- serve be good for fit for sirbicial - obliging complaisant sirbidor 
- waiter sirbishi 
- service sirema 
- siren sistema 
- system sistematicamente - sys¬ tematically sitio 
- site situa 
- si¬ tuated situacion 
- situation sjers 
- gig sjower 
- porter skaaf 

. plane 
to plane skaars 
- scarce skarnier 
- hinge skeel 
- cockeyed cross-eyed skeif 

- slide to shove to push skeins 
- crooked slanting sloping skeiru 

- brush to brush skeiru di diente - tooth¬ brush snoei skeiru di panja - clothes- brush gljer 
- pair of scissors skerpi 
- sharp skirbi 
- to write skirbi 
- writ¬ ten skirbimentu - writing skommel 

- swing to swing to rock skop 
- kick to kick schopapel - sugar-apple skot - partition skotter 
- saucer skouder 
- shoulder skreef 
- line stroke skribi 
- to write skroef 
- screw skroefdraai 
- screwdriver skrif 
- copybook skuma 
- to foam skuma 
- foam slag - blow slap - supple flaccid limp slingu 
- left-handed slip 
- to glide out slip slof - slipper slons - untidy sloven slopi 
- pil¬ low case slot - lock sluim - slime phlegm mucous smaak - taste smaak 
- tasteless smal 
- narrow smeer 
- grease fat tallow smoki - a smoking 
snechi 
- a slice sneif 
- snuff sneiru 
- tailor snijboonchi - string beans snik - to sigh snoei - to prune to clip  snoek snoek - pike 
snoep - candy dainties so 
- only alone sobra (soh-brah - remainder sobra 
- super¬ fluous sobra 
- left over remainder sobrecama - bed spread quilt sobresaliente - out¬ standing sobrina subrina - niece sobrmo 
- nephew socede 
to happen to occur befall social 
- social socialismo 
- part-  soda 
perspire soda 
. in « sweat sofa - couch sofoca 
- to sufficate soketade 
- stupidity dullness sokete 
- dotard fool foolish sokle - partridge solamente 
- alone only solda 
- soldier soldachi 
- hermit crab soldeer 
- to solder soldeerbout - soldering iron ^ solitary solein - solemn solicita 
to apply solicitacion - appli¬ cation solitario - solitary solo spat solo 
- sun soltero 
- bachelor solucion 
< solution som - sun sombra 
- shadow sombre 
- hat sombra di aroz - man’s 
sombra di cabana - pana¬ ma hat somenta 
- to disappear sonjo sono 
- sleep soporta - to support soppi 
- soup soppi delega 
- broth sopresa 
- surprise sorsaca - soursop 
sorto 
- sort kind sosega 
- to rest sosiegu sosiego 
- rest sosiegu 
- without rest sospecha 
- to suspect sospecho 
- suspicion mistrust sospechoso 
- suspicious sostene 
- to keep up support sota 
- to flog to beat spaar - to save spaarbank - savings bank spacio 
- space spada 
- dagger spalk - splint spalki - splinting spanja 
- spain span jo 
- spaniard spanta 
- be frightened spantu 
- fear anxiety sparkplug - sparkplug spat - to spatter spot speck fleck  special stanja special 
- special specialista - specialist specialisa - to specia¬ lize specialmente 
- especially specifica 
- to specify specifico - specific spekki 
- pork spera 
- to hope expect wait speranza 
- hope spiel 
- mirror spierta 
- to awake spierta 
- awake spiertu 
- ingenious quick to grasp things easily spinja 
- thorn spion 
- spy spiona 
- to spy spiral 
- spiral spiritismo - spiritualism spiritista 
- spiritualist spiritu - ghost spiritu santo - holy ghost spiritual - spiritual splendor - splendor splica 
- to explain splica splee-kah) - ex¬ plained splicacion - explanation splinter - splinter spoela 
- to rinse spons - sponge spreit spruit - to sprout staca 
- stake pole stacion 

- to station staciona - stationed stal 
- steel stampia 
- postage stamp stanja 
- to tin  start stof start - to start statua 
- statue image statura 
- stature stedloop - to play truant stedskool - to play truant steef 
- bow 
stekki 
- cutting slip stenografia - stenography stenografista - stenograp¬ her steril 
- sterile sterilisa 
- to sterilize sterilisacion - sterili¬ zation sterki 
- strong powerful stichi 
- a sling catapult stilo 
- style way stima 
- to love stima 
- beloved stimacion 
- love stimula 
- to stimulate stimulanfe 
- stimulant stiu - stow push propel stipula 
- stipulate stipulacion - stipula¬ tion stiwa - to stow stoba 
- to stew stoba 
- stewed stoei - to push horse¬ play stoeimento - horseplay stul stoei 
- chair stul di rabu - rocking- chair stul di zoja - rocking chair stoepi - doorstep gal¬ lery stof - dust  stoma subrina stoma 
- stomach stompi 
- dull stoom 
- steam stop - stop cease stopverf - putty strangula 
- to choke strangle stranhero 
- stranger foreig¬ ner stranja 
- to wonder to surprise stranjo 
- strange strategia 
- strategy strena 
- thunder strepi 
- streak stroke line streja 
- star strica 
- to iron strica 
- ironed stricto 
- strict strijkstok - violin bow stroba 
- to prevent hinder impede stroba 
- prevented strobacion - impedi¬ ment obstruction prevention stropi - syrup mol¬ asses stropia - tired structura - structure studia - study stuipi 
- fit stut - stud su 
- his her its subi 
- to ascend rise up get up subi fli 
- to fly a kite submarin 
- submarine su mes 
- himself herself itself subrina 
- niece  # subrino suspira subrino 
- nephew substitui - to substitute sucu 
- sugar sucu larga - brown sugar sucu papilon 
- white sugar sucu 
- dark sucumbi 
- succumb suegro 
- father-in-law suegra 
- daughter-in-law suela 
- floor suerte 
- luck suficiente 
- sufficient suficientemente - suffi¬ ciently sufri 
- to suffer sufrimentu - suffering sugeri - suggest suiza - switzerland suizo - swiss sulfura 
- to make angry suma 
- amount sum sunchi 
- kiss sunu 
- naked nude superior 
- superior supla 
- to blow supla nanishi - to blow your nose suplica 
- to request implore supremo 
- supreme surdu 
- deaf surti 
- to assert suscripcion - subscrip¬ tion shusha 
- to soil shusha 
- soiled sushi 
- dirty obscene suspira 
- to sigh  suspiro suspiro 
- sigh suta 
- to beat spank swa 
- brother-in- law switch 
- switch t ta 
- am is are taai - tough ta duele 
- it’s a pity tabacu 
- to¬ bacco tabata 
- was were ’ tabatin 
- had tabla 
- board tableta 
- tablet tachuela 
- tack tacto 
- tact tafetan - taffeta tafia 
- table¬ cloth taha 
- to forbid prevent taha 
- forbid¬ den taja 
- tire tajo 
- plate dish ta kico - what is it takki 
- branch talco 
- talc talent 
- talent tal y tal - that and that tal y tal manera - so and so in what way tam 
- tame tamanjo 
■ size tamarein - tamarind 
tambe 
- also tamboer - drum tamboer di orea - ear drum tanki 
- tank tanquero - tanker tampoco 
- neither - no more than tanta 
- aunt  tempera l^ntan tantan 
- auntie tantem 
- so long till later tantu 
- so much tao - to tow taoboot 
- tow boat tap - to tap to draw off tapa 
- to cover tapa 
- covered tapijt 
- carpet tapushi 
- ear of corn tarda 
- to be tardy to delay to tarry tarea - task tarifa di cambio - rate of exchange tarifa - schedule tata 
- father ta taha 
- it’s forbidden prohi¬ bited tawela 
- great-grandfather te 
- till tea teater - theatre show teatro 
- theatre tela 
- cloth telefon 
- telephone telefona 
- to telephone telefonista 
- tele¬ phone operator telegrafia 
- tele¬ graphy telegrafista 
- tele¬ grapher telegram - telegram cablegram tern tempu - time tembla 
- tremble temblor 
- earthquake tempea - to temper tempera 
- to season 
temperatura testament temperatura 
- temperature tempestad 
- tempest temporal 
- temporal tempran 
- early tempu tempo 
- time weather tempu di berano - famine tempu di jobida - rainy season tempu 

- on time tempu 
- at the same time tende 
- to hear tene atras - hold back tene 
- to hold to keep tene buki - to keep books 
tenchi 
- slender slim tennis - tennis tenta 
- to tease aggravate tentacion - temptation  tentador 
- teaser te ora 
- till teoria - theory tera (tay-rah - ground earth land tera bona - fertile land tera ricu - fertile land tercio - fellow dunce booby tereno - land terg - to tease teribel 
- terrible termina 
- to terminate to end terminacion - termination termino 
- term termo 
- vacuum container termometer - thermometer terpentijn - turpentine terrein - soup bowl tesoro 
- treasure test 
- to test test testament 
- last will testigu tira rais testigu 
- evidence witness testigua - to testify to witness testimonio 
- tes¬ timony evidence tetano 
- tetanus tete 
- tit nipple udder tetero 
- nursing bottle texto 
- text tibio 
- lukewarm tienda - shop tifus 
- typhus tiger 
- tiger tiki 
- a mor¬ sel a small portion timido 
- timid shy timon 
- rudder tin 
- have has tin be 
- some times tin bon suerte - to be lucky have good luck tino 
- atten¬ tion understanding tintura 
- tincture tipico 
- typical tipu 
- type model tira 
- to throw to shoot tira 
- thrown shot tira afo - throw-away tira discurso - to give a speech tiracochi 
- grasshopper tira cochi - a horse's kick tira contrabanda - to smuggle tirador 
- hunter tira mata - to shoot tira na cara - to reproach blame tirania 
- tyranny tira rais - to take root  tiru 
- shot titulo 
- title tobo 
- tub toca 
- to play 
tocador 
- musician tocai 
- namesake tocante 
- concerning regarding in respect to toch - still yet todopoderoso - al¬ mighty todos los difuntos - all-soufs day todos los santos - all-saints day tolera 
- to bear tolerate tomati 
- tomato tomo 
- volume 
tonchi 
- heel of the foot tono 
- tone sound toorchi - tower topa 
- to meet tormenta - to torment tormentamentu - torment toro 
- bull torpeda 
- to torpedo torpedo 
- torpedo torto 
- one- eyed tortuga 
- turtle tos 
- cough tosa 
- to cough tosamentu 
- fit of coughing tota 
- to roast total 
- total totin - one-eyed person  totolica trapa morto totolica 
- stone dove trabahoso 
- difficult hard trabao 
- work tradicion 
- tradition traduci 
- to translate traducion 
- translation trafico 
- traffic traga 
- to swallow tragico 
- tragic traha 
- to work build make traha 
- built made worked traha carpinte - to work at carpentry traha duro 
- work hard trahador 
- workman laborer trahador di sombre - hat¬ ter traha smid - to work as a blacksmith traicion - treason traidor 
- traitor trajecto 
- way distance stretch tralie 
- lat¬ tice grate trellis trampa 
- trap pitfall tranca 
- bar 
trankera 
- fence trankil tranquil - tranquil transito 
- transit transport - to trans¬ port transfer transportacion - trans¬ portation trapa 
- trample tread on trapa morto - trample to death  trapi 
- lad¬ der step tras di - behind trasteria 
- hypocrisy trastu 

- simulate feign trata 
- to treat tratamentu 
- treatment tratu 
- treatment trece 
- to bring trece hasta la fecha - bring up to date trei merdia - afternoon trek - draught trekpochi - coffee pot trempan - early tres 
- three triano 
- triangle tribi 
- ar¬ rogant overbearing tribilidad - arrogance presumption tribu 
- tribe tribuna 
- tribunal trocolor 
tricolor trinashi 
um trinchera 
- trench trinidad - trinity trintaria - bougain¬ villea trinta 
- thirty trio 
- trio tripa 
- entrails tripe tripel 
- triple threefold tripula 
- to muster a crew triplacion 
- crew tristesa 
- sorrow sad¬ ness tristu 
- sad sorry troca 
- to change  troca cos tur hende troca cos - to change houses troca panja - to change clothes troce 
- to sprain to wring to twist troebel - turbid cloudy troepa 
- troop gang trom - drum tromchi 
- drum box case trimcho di pan - bread box trompeca 
- to stumble trip trompet 
- trumpet troncon 
- stump of a tree trono 
- throne trishi 
- bunch trouwchi 
- wedding ring trupial 
- trupial 
tualet 
- dres¬ ser dressing table tubo 
- tube tuberculose - tuberculosis tubero 
- pipefitter tubo 
- pipe tube tuma 
- to take accept tuma medida - to take measure tuma midi - to take measurement tuma na curazon - to take to heart tuma na malu - to become ill of tuma over - to take over tuma pa - take for tuma parti - take part txunba 
- to pull down tumba 
- a dance tumba abao - to pull down tur toor) - all tur cos - everything tur hende - everybody turco vale turco - turk turdi 
- besotted foolish turista 
- tourist turkia - turkey tortuga 
- turtle tutu 
- flour 
mixture of flour meal etc. u ultimo 
- last umbe 
- at once un 
- a one un be un bez 
- at once un cos 
- some¬ thing unda 
- where un dia 
- one day un hende 
- somebody un poco 
- a little un ratu 
- a while uni (
- to unite uni 
- united unico 
- only the only one uniform - uniform union - union universal - universal universe - universe urina - to urinate urina - urine usa 
- to use usa 
- used uso 
- usage util 
- use¬ ful utilisa 
- to utilize v vaas 
- vase vacanci vacacion - vacation valchi 
- trap vale 
- i. o. u.  valies vicario valiss 
suitcase varia 
different varies 
- various veer 
- spring vehiculo 
- vehicle velocidad - velocity vendishi 
- sale venena 
- to poison veneno 
- poison venenoso 
- poisonous venezolano - venezuelan venezuela - venezuela venga 
- to wreak 
vengansa 
- revenge vengativo - revenge¬ ful vense - mortar venta 
- sale ventaha 
- advantage verbo 
- verb verdiep 
- to deepen verdriet 
- sorrow grief verf - paint verfdo 
- painter verifica - to verify verificacion - veri¬ fication verkoud verkou 
- to have a cold verlei - mislead verloof 
- engage verloofmentu 
- engage¬ ment vers - verse verso - verse via 
- via vibra 
- vi¬ brate vibracion 
- vibration vicario 
- vicar  vicariato vicariato (vee-kah-ree- - vicarious - dirty rilthy nasty vigilia 
- . to guard vyla 
- to file vijlu 
- file vio 
- violin viola 
- to violate violacion - violation violente - violent ^isibel 
. visible visibilidad 
- visibility vitamina 
- vitamin vito - manager of an estate vechte - plait vocabulario - vocabu- lary volcan - volcano voogd - guardian voorskot - loan voz boz - voice  wapu vrij 
. to court vrijashi - courtship vrumon - midwife vulgar - vulgar vulnerabel - vulne¬ rable vunsucu - fire cracker squib w waaf 
- wharf waairu 
- fair waak - to guard waal 
- shawl wagen di morto - hearse waja waya - wire ga^ waja <ii i„ . electifr wire wals - waltz to waltz wangi - maggot grub wanja - worm bear to hold sap*° support blow 
- fender 
vvapu 
-'brave courageous warda ytroo warda 
- to guard to wait to keep to protect warda 
- police station warda 
- shift wardador - guard was - wax washi - scrubbing board webu 
- egg webu di bientu - shirred egg wga 
- game wega di ladron - dis¬ honest game wega di man - horse- weja di respet - chamber¬ pot weerlicht - lightning weita 
- to see wela 
- grand- mother wenkbrauw 
- eyelash werfano 
- orphan werki 
- work werp - to bear young west - west wesu 
- bone weta 
- see look wieg - cradle wiel 
- wheel winchi 
- capstan winkel 
- work¬ shop winkel di smid - smithy wiri-wiri 
- crumb wiri-wiri pan - bread crumbs worde 
- to become to turn wors 
- sausage wowo 
- eye wo wo ala - sober 
wowo di baca - fried egg wowo di carinjo - wink 
- flirtish eyes y 
js 
- ice 
jscreani 
son-in-law yerno 
- ice-cream  zaag zwiep z zaag 
- saw 
zaag di heru - hack-saw zaai - to sow zalfi - salve zapatu sapatu 
- shoe zantu 
- sand zee-appel - sea-egg zee-dreifi - seaside grapes zee-kat - ink-fish cuttle-fish zeppelin - zeppelin zeta azeta 
- oil zeta 
- to oil zeta bakijao - codliver oil zeta dushi - sweet oil zier - sour zim - sink zink - to sink zip - zip zoja - to rock zona 
- to sound zonido 
- sound zonnebloem - sunflower zono - sound zons - to rustle zonzo - to run amok zool - sole zoolleer - sole leather zoologio - zoology zumbi 
- spirit ghost phantom zumbi 
- mushroom zundra 
- to curse to swear to abuse zundra - cursed zundramenfu - abuse zuri 
- to buzz hum drone zuri di sonjo - very very sleepy zuta suta - to beat spank zwak - weak feeble zwiep - whip  err a t a english - paplamentu section page ffo.  ik     o kl k       l  page kb.             page hb. reverse: oh-sen-tay and  oh-sen-see-ah  
bill - 
- cuenta  erase: "cash" cask - barril  cigar - siga clga  cigarette - sigaria cigaria dirty - shushi 

forbid - prohobi taha  hem - zoom  hundredth - e di cien  infant - jlu di lechi  
itch - grawatashi  jail - piscala  erase; 
lice - pieu  potente belongs by mighty  ninetieth - e di nobenta paplamentu - english acera 
page kb.  adoracion  anhelo - desire wish  baki - trough  blra  erase: "insane"  obsolete - blra bleu add: perhaps - podlce^ quizes klzas razor - nabaha richest - e dl mas rlcu rum - ron sigh - susplra sore - had due spine - vesu dl lomba stepfather 
street - caja caya tack 
though - maske' erase: "truck" trouser - carson trash - basura 
unfit - incompetente violin - string vide - hanchu 
wing - eula 
hala 
worship - respeti blekero canoa carpinteria - carpentry 
contrabanda - contraband dura 
delete at the beginnning of papij in wrong location. fada 
gana - earn hoos - waterspout mondongo padrasa - stepfather pastechi petrechi 
pensa 
cas ice-cream and son-in-law pronunciation" and "grammar v 